夏园	xia'yuan
南湾	nan'wan
庙头	miao'tou
南海神庙	nan'hai'shen'miao
沙浦	sha'pu
双岗	shuang'gang
黄埔客运站	huang'pu'ke'yun'zhan
乌冲	wu'chong
下沙	xia'sha
珠江村	zhu'jiang'cun
茅岗	mao'gang
莲溪	lian'xi
珠村	zhu'cun
黄村	huang'cun
东圃镇	dong'pu'zhen
车陂	che'bei
天朗明居	tian'lang'ming'ju
棠东	tang'dong
棠下村	tang'xia'cun
学院	xue'yuan
上社	shang'she
华景新城	hua'jing'xin'cheng
师大暨大	shi'da'ji'da
岗顶	gang'ding
石牌桥	shi'pai'qiao
体育中心	ti'yu'zhong'xin
广州火车站总站	guang'zhou'huo'che'zhan'zong'zhan
电视塔	dian'shi'ta
花园酒店	hua'yuan'jiu'dian
广东工大	guang'dong'gong'da
动物园南门	dong'wu'yuan'nan'men
桃园东路	tao'yuan'dong'lu
莲溪路口	lian'xi'lu'kou
汇彩路总站	hui'cai'lu'zong'zhan
汇彩路	hui'cai'lu
珠村路	zhu'cun'lu
白云宾馆	bai'yun'bin'guan
越秀公园北门	yue'xiu'gong'yuan'bei'men
东圃总站	dong'pu'zong'zhan
罗冲围总站	luo'chong'wei'zong'zhan
松南路口	song'nan'lu'kou
罗冲围客运站	luo'chong'wei'ke'yun'zhan
富力半岛花园	fu'li'ban'dao'hua'yuan
西场电器城	xi'chang'dian'qi'cheng
和平新村	he'ping'xin'cun
东风西路	dong'feng'xi'lu
市少年宫	shi'shao'nian'gong
广医	guang'yi
中山纪念堂	zhong'shan'ji'nian'tang
广东大厦	guang'dong'da'sha
正骨医院	zheng'gu'yi'yuan
东风东路	dong'feng'dong'lu
先烈南路	xian'lie'nan'lu
天河立交	tian'he'li'jiao
东圃客运站	dong'pu'ke'yun'zhan
越秀桥	yue'xiu'qiao
东风中路	dong'feng'zhong'lu
松南街口	song'nan'jie'kou
松北	song'bei
广仁路总站	guang'ren'lu'zong'zhan
执信路	zhi'xin'lu
东风东路	dong'feng'dong'lu
东峻广场	dong'jun'guang'chang
锦城花园	jin'cheng'hua'yuan
黄村路口	huang'cun'lu'kou
奥林匹克中心西门	ao'lin'pi'ke'zhong'xin'xi'men
地铁大观南路站	di'tie'da'guan'nan'lu'zhan
大观中路	da'guan'zhong'lu
大观中路南	da'guan'zhong'lu'nan
科学城路口	ke'xue'cheng'lu'kou
光宝路口	guang'bao'lu'kou
光谱西路	guang'pu'xi'lu
光谱西路中	guang'pu'xi'lu'zhong
光谱西路	guang'pu'xi'lu
神舟路	shen'zhou'lu
科学大道中	ke'xue'da'dao'zhong
科学信息大厦	ke'xue'xin'xi'da'sha
科学大道	ke'xue'da'dao
聆雨路路口	ling'yu'lu'lu'kou
开泰大道	kai'tai'da'dao
科学城总站	ke'xue'cheng'zong'zhan
开泰大道	kai'tai'da'dao
黄村西路	huang'cun'xi'lu
肿瘤医院	zhong'liu'yi'yuan
中山纪念堂	zhong'shan'ji'nian'tang
合景路东	he'jing'lu'dong
合景路	he'jing'lu
沐陂村	mu'bei'cun
天河智慧城核心区总站	tian'he'zhi'hui'cheng'he'xin'qu'zong'zhan
软件路	ruan'jian'lu
小新塘	xiao'xin'tang
棠德小区北	tang'de'xiao'qu'bei
省农干科干院	sheng'nong'gan'ke'gan'yuan
农科院	nong'ke'yuan
师大后门	shi'da'hou'men
天河科技街	tian'he'ke'ji'jie
科学大道口	ke'xue'da'dao'kou
天河软件园管委会	tian'he'ruan'jian'yuan'guan'wei'hui
高普路软件路口	gao'pu'lu'ruan'jian'lu'kou
高普路天盈路口	gao'pu'lu'tian'ying'lu'kou
黄埔港	huang'pu'gang
杨箕村	yang'ji'cun
梅花村	mei'hua'cun
农林东	nong'lin'dong
东山口	dong'shan'kou
东华南路	dong'hua'nan'lu
江湾桥脚	jiang'wan'qiao'jiao
江湾桥南	jiang'wan'qiao'nan
基立下道	ji'li'xia'dao
江南大道口	jiang'nan'da'dao'kou
宝岗大道总站	bao'gang'da'dao'zong'zhan
广东药学院	guang'dong'yao'xue'yuan
荔香路南	li'xiang'lu'nan
同和路总站	tong'he'lu'zong'zhan
林科所	lin'ke'suo
老庄	lao'zhuang
南湖乐园	nan'hu'le'yuan
斯文井	si'wen'jing
同和榕树头	tong'he'rong'shu'tou
同和	tong'he
东坑	dong'keng
南方医院	nan'fang'yi'yuan
一五七医院	yi'wu'qi'yi'yuan
梅花园	mei'hua'yuan
梅园新村	mei'yuan'xin'cun
鸡颈坑	ji'jing'keng
伍仙桥	wu'xian'qiao
兴华路口	xing'hua'lu'kou
豪景花园	hao'jing'hua'yuan
省军区	sheng'jun'qu
东站汽车客运站	dong'zhan'qi'che'ke'yun'zhan
广园天寿路口东	guang'yuan'tian'shou'lu'kou'dong
科韵路棠安路口	ke'yun'lu'tang'an'lu'kou
广州大道中	guang'zhou'da'dao'zhong
广州体院	guang'zhou'ti'yuan
白云区医院	bai'yun'qu'yi'yuan
南湖半山	nan'hu'ban'shan
海珠客运站	hai'zhu'ke'yun'zhan
洛溪桥脚	luo'xi'qiao'jiao
上涌南	shang'yong'nan
上涌	shang'yong
园艺场	yuan'yi'chang
敦和	dun'he
珠影	zhu'ying
赤岗路口	chi'gang'lu'kou
赤岗	chi'gang
磨碟沙	mo'die'sha
海港花园	hai'gang'hua'yuan
广交会展馆	guang'jiao'hui'zhan'guan
琶洲	pa'zhou
琶洲大桥北	pa'zhou'da'qiao'bei
科韵路	ke'yun'lu
海珠客运站	hai'zhu'ke'yun'zhan
磨碟沙路	mo'die'sha'lu
芳园路口	fang'yuan'lu'kou
阅江西路西	yue'jiang'xi'lu'xi
阅江西路中	yue'jiang'xi'lu'zhong
阅江西路东	yue'jiang'xi'lu'dong
会展公园	hui'zhan'gong'yuan
阅江中路	yue'jiang'zhong'lu
会展中心码头	hui'zhan'zhong'xin'ma'tou
会展中心北	hui'zhan'zhong'xin'bei
琶洲大道东	pa'zhou'da'dao'dong
琶洲大桥南	pa'zhou'da'qiao'nan
会展东路	hui'zhan'dong'lu
艺洲路东	yi'zhou'lu'dong
艺苑路	yi'yuan'lu
宝岗大道北	bao'gang'da'dao'bei
市红会医院	shi'hong'hui'yi'yuan
解放南路	jie'fang'nan'lu
大南路	da'nan'lu
文明路	wen'ming'lu
中山图书馆	zhong'shan'tu'shu'guan
三角市	san'jiao'shi
较场西路	jiao'chang'xi'lu
烈士陵园	lie'shi'ling'yuan
中山医	zhong'shan'yi
东山口	dong'shan'kou
天河	tian'he
冼村	xian'cun
石牌村	shi'pai'cun
国防大厦	guo'fang'da'sha
华侨医院	hua'qiao'yi'yuan
员村山顶	yuan'cun'shan'ding
天府路	tian'fu'lu
天河公园	tian'he'gong'yuan
家家乐医院	jia'jia'le'yi'yuan
泰安花园	tai'an'hua'yuan
地铁棠东站	di'tie'tang'dong'zhan
棠下小区总站	tang'xia'xiao'qu'zong'zhan
人民日报广东分社	ren'min'ri'bao'guang'dong'fen'she
北京路口	bei'jing'lu'kou
堑口	qian'kou
宝岗大道中	bao'gang'da'dao'zhong
华景新城总站	hua'jing'xin'cheng'zong'zhan
华景北路	hua'jing'bei'lu
华景新村	hua'jing'xin'cun
华景路口	hua'jing'lu'kou
南方报社	nan'fang'bao'she
广州大桥北	guang'zhou'da'qiao'bei
客村立交	ke'cun'li'jiao
鹭江	lu'jiang
康乐村	kang'le'cun
中山大学	zhong'shan'da'xue
省荣军医院	sheng'rong'jun'yi'yuan
怡乐村	yi'le'cun
广医二院	guang'yi'er'yuan
礼岗	li'gang
江燕花园	jiang'yan'hua'yuan
燕子岗	yan'zi'gang
珠江南景园总站	zhu'jiang'nan'jing'yuan'zong'zhan
东方一路口	dong'fang'yi'lu'kou
东方一路	dong'fang'yi'lu
东方三路	dong'fang'san'lu
华师大南门	hua'shi'da'nan'men
华师附中	hua'shi'fu'zhong
华工大	hua'gong'da
华农大正门	hua'nong'da'zheng'men
五山学生公寓	wu'shan'xue'sheng'gong'yu
苗圃	miao'pu
岑村公安宿舍	cen'cun'gong'an'su'she
岑村	cen'cun
华观路	hua'guan'lu
华观路总站	hua'guan'lu'zong'zhan
广东电视台	guang'dong'dian'shi'tai
凌塘环村路总站	ling'tang'huan'cun'lu'zong'zhan
凌塘村	ling'tang'cun
华观路	hua'guan'lu
长兴路东	chang'xing'lu'dong
伟伦体校	wei'lun'ti'xiao
长湴市场	zhang'ban'shi'chang
天鹅花园	tian'e'hua'yuan
长兴路口	chang'xing'lu'kou
上元岗	shang'yuan'gang
天河客运站	tian'he'ke'yun'zhan
银河园	yin'he'yuan
武警医院	wu'jing'yi'yuan
燕塘企业	yan'tang'qi'ye
燕岭大厦	yan'ling'da'sha
金燕生活区	jin'yan'sheng'huo'qu
粤垦路瑞心苑	yue'ken'lu'rui'xin'yuan
农垦总局	nong'ken'zong'ju
春晖苑	chun'hui'yuan
天寿路	tian'shou'lu
天润路口	tian'run'lu'kou
穗园小区	sui'yuan'xiao'qu
天润路	tian'run'lu
五山路口	wu'shan'lu'kou
员村	yuan'cun
程界村	cheng'jie'cun
员村四横路口	yuan'cun'si'heng'lu'kou
员村总站	yuan'cun'zong'zhan
员村四横路	yuan'cun'si'heng'lu
龙口东	long'kou'dong
龙口西	long'kou'xi
长福路	zhang'fu'lu
轻工中专	qing'gong'zhong'zhuan
长福路东	zhang'fu'lu'dong
车陂总站	che'bei'zong'zhan
车陂公交场	che'bei'gong'jiao'chang
车陂路	che'bei'lu
军体院	jun'ti'yuan
射击场	she'ji'chang
天源路中	tian'yuan'lu'zhong
科学院	ke'xue'yuan
三宝墟	san'bao'xu
植物园正门	zhi'wu'yuan'zheng'men
天源路总站	tian'yuan'lu'zong'zhan
龙洞牌坊	long'dong'pai'fang
地铁植物园站	di'tie'zhi'wu'yuan'zhan
地铁长湴站	di'tie'zhang'ban'zhan
棠下村	tang'xia'cun
小区东路	xiao'qu'dong'lu
泰安北路	tai'an'bei'lu
棠德南路	tang'de'nan'lu
棠德路	tang'de'lu
锦城花园总站	jin'cheng'hua'yuan'zong'zhan
员村东	yuan'cun'dong
黄埔大道	huang'pu'da'dao
护林路	hu'lin'lu
珠吉公路	zhu'ji'gong'lu
吉山新路街	ji'shan'xin'lu'jie
吉山村委	ji'shan'cun'wei
天河儿童公园北门总站	tian'he'er'tong'gong'yuan'bei'men'zong'zhan
吉山幼儿园	ji'shan'you'er'yuan
潮汕学院	chao'shan'xue'yuan
珠村小学	zhu'cun'xiao'xue
珠吉路口	zhu'ji'lu'kou
车陂南	che'bei'nan
云台花园	yun'tai'hua'yuan
白云索道	bai'yun'suo'dao
金贵村	jin'gui'cun
濂泉路口	lian'quan'lu'kou
时代广场	shi'dai'guang'chang
天河北路	tian'he'bei'lu
天河东路	tian'he'dong'lu
天河东路口	tian'he'dong'lu'kou
大沙地	da'sha'di
大沙西	da'sha'xi
大沙东	da'sha'dong
丰乐北路	feng'le'bei'lu
大沙北路	da'sha'bei'lu
黄埔体育中心总站	huang'pu'ti'yu'zhong'xin'zong'zhan
沙河	sha'he
广州火车东站	guang'zhou'huo'che'dong'zhan
林和西路	lin'he'xi'lu
文冲村委	wen'chong'cun'wei
石化路总站	shi'hua'lu'zong'zhan
林和中路	lin'he'zhong'lu
汇彩路北总站	hui'cai'lu'bei'zong'zhan
车陂路口	che'bei'lu'kou
柯子岭牌坊	ke'zi'ling'pai'fang
云城中一路	yun'cheng'zhong'yi'lu
广外	guang'wai
黄石东路口	huang'shi'dong'lu'kou
陈田村	chen'tian'cun
元下田	yuan'xia'tian
永泰路口	yong'tai'lu'kou
永泰客运站	yong'tai'ke'yun'zhan
永泰广场	yong'tai'guang'chang
永泰新村口	yong'tai'xin'cun'kou
广州体育馆	guang'zhou'ti'yu'guan
白云大道南	bai'yun'da'dao'nan
大金钟路	da'jin'zhong'lu
白云山管理局	bai'yun'shan'guan'li'ju
科学院地化所	ke'xue'yuan'di'hua'suo
消防总队	xiao'fang'zong'dui
瘦狗岭	shou'gou'ling
杨桃公园总站	yang'tao'gong'yuan'zong'zhan
桃园路	tao'yuan'lu
林和东路	lin'he'dong'lu
林乐路	lin'le'lu
革新路总站	ge'xin'lu'zong'zhan
金沙路	jin'sha'lu
沙园	sha'yuan
梅园西	mei'yuan'xi
革新路口	ge'xin'lu'kou
洪德路	hong'de'lu
同福西	tong'fu'xi
同福中	tong'fu'zhong
市二宫	shi'er'gong
江南大道北	jiang'nan'da'dao'bei
南华东路	nan'hua'dong'lu
草芳围	cao'fang'wei
大元帅府	da'yuan'shuai'fu
石涌口	shi'yong'kou
滨江东路	bin'jiang'dong'lu
沿江东路	yan'jiang'dong'lu
二沙西	er'sha'xi
省中医二沙分院	sheng'zhong'yi'er'sha'fen'yuan
星海音乐厅	xing'hai'yin'yue'ting
二沙东	er'sha'dong
星海音乐厅	xing'hai'yin'yue'ting
大沙头游船码头	da'sha'tou'you'chuan'ma'tou
海珠桥底	hai'zhu'qiao'di
海幢寺	hai'chuang'si
大基头	da'ji'tou
凤凰岗	feng'huang'gang
五羊邨	wu'yang'cun
花城大道	hua'cheng'da'dao
星汇园	xing'hui'yuan
彩频路	cai'pin'lu
广东软件园	guang'dong'ruan'jian'yuan
神舟路中	shen'zhou'lu'zhong
神舟路北	shen'zhou'lu'bei
香山路南	xiang'shan'lu'nan
香山路中	xiang'shan'lu'zhong
广州科学城总站	guang'zhou'ke'xue'cheng'zong'zhan
科珠路	ke'zhu'lu
科韵路公交场	ke'yun'lu'gong'jiao'chang
猎德大道北	lie'de'da'dao'bei
金穗路	jin'sui'lu
华穗路	hua'sui'lu
东圃总站	dong'pu'zong'zhan
明珠新村	ming'zhu'xin'cun
东圃	dong'pu
东圃石溪村	dong'pu'shi'xi'cun
石溪村口	shi'xi'cun'kou
黄埔体育馆	huang'pu'ti'yu'guan
碧山村	bi'shan'cun
丰乐北横路口	feng'le'bei'heng'lu'kou
姬堂	ji'tang
上堂	shang'tang
丰乐北路	feng'le'bei'lu
姬堂商业街	ji'tang'shang'ye'jie
文加路	wen'jia'lu
旧围村	jiu'wei'cun
枝山村	zhi'shan'cun
岗头	gang'tou
开发区加速产业园区	kai'fa'qu'jia'su'chan'ye'yuan'qu
火村	huo'cun
瑞和路口	rui'he'lu'kou
开泰大道	kai'tai'da'dao
开泰大道	kai'tai'da'dao
开泰大道	kai'tai'da'dao
荔红二路	li'hong'er'lu
萝岗香雪牌坊	luo'gang'xiang'xue'pai'fang
下中路总站	xia'zhong'lu'zong'zhan
北山	bei'shan
风茂街	feng'mao'jie
星海学院	xing'hai'xue'yuan
华师	hua'shi
广大生活区	guang'da'sheng'huo'qu
广大	guang'da
广大公寓	guang'da'gong'yu
广美生活区	guang'mei'sheng'huo'qu
美术学院	mei'shu'xue'yuan
市国家档案馆南	shi'guo'jia'dang'an'guan'nan
大学城中部枢纽总站	da'xue'cheng'zhong'bu'shu'niu'zong'zhan
综合商业北区	zong'he'shang'ye'bei'qu
仑头立交	lun'tou'li'jiao
南岗	nan'gang
南岗	nan'gang
南岗化工厂	nan'gang'hua'gong'chang
丹水坑	dan'shui'keng
塘头	tang'tou
开发大道立交东	kai'fa'da'dao'li'jiao'dong
软件路西	ruan'jian'lu'xi
高唐路	gao'tang'lu
凌塘村	ling'tang'cun
黄埔客运站	huang'pu'ke'yun'zhan
地铁鱼珠站总站	di'tie'yu'zhu'zhan'zong'zhan
丰乐路	feng'le'lu
开发区路口	kai'fa'qu'lu'kou
保税区西门	bao'shui'qu'xi'men
青年路口	qing'nian'lu'kou
创业路口	chuang'ye'lu'kou
创业路	chuang'ye'lu
开发区医院	kai'fa'qu'yi'yuan
友谊路	you'yi'lu
保税区南门	bao'shui'qu'nan'men
广保大道南	guang'bao'da'dao'nan
广保大道北	guang'bao'da'dao'bei
保税区总站	bao'shui'qu'zong'zhan
西基总站	xi'ji'zong'zhan
东基	dong'ji
文冲市场	wen'chong'shi'chang
黄埔区儿童公园	huang'pu'qu'er'tong'gong'yuan
黄埔区少年宫	huang'pu'qu'shao'nian'gong
广州本田公司	guang'zhou'ben'tian'gong'si
茅岗路口	mao'gang'lu'kou
边防指挥学校	bian'fang'zhi'hui'xue'xiao
奥体南路	ao'ti'nan'lu
奥林匹克体育中心总站	ao'lin'pi'ke'ti'yu'zhong'xin'zong'zhan
康南路北	kang'nan'lu'bei
康南路	kang'nan'lu
宝丰路	bao'feng'lu
富南路南	fu'nan'lu'nan
富南路北	fu'nan'lu'bei
东区路口	dong'qu'lu'kou
广新路	guang'xin'lu
海安社区	hai'an'she'qu
港湾路口	gang'wan'lu'kou
港湾市场	gang'wan'shi'chang
东苑小区	dong'yuan'xiao'qu
茅岗公寓	mao'gang'gong'yu
茅岗新村总站	mao'gang'xin'cun'zong'zhan
开发区总站	kai'fa'qu'zong'zhan
新安路	xin'an'lu
永顺大道	yong'shun'da'dao
永和开发区	yong'he'kai'fa'qu
新庄二路	xin'zhuang'er'lu
永和大道中	yong'he'da'dao'zhong
永和隧道南	yong'he'sui'dao'nan
永和大道	yong'he'da'dao
洋城学校	yang'cheng'xue'xiao
萝岗村口	luo'gang'cun'kou
广州海关车检场	guang'zhou'hai'guan'che'jian'chang
云埔工业区	yun'bu'gong'ye'qu
荷村	he'cun
骏业路口	jun'ye'lu'kou
开创大道中	kai'chuang'da'dao'zhong
开创大道	kai'chuang'da'dao
严田村	yan'tian'cun
宏光路口	hong'guang'lu'kou
开创大道口	kai'chuang'da'dao'kou
黄埔港	huang'pu'gang
中码头	zhong'ma'tou
蟹山西	xie'shan'xi
鱼珠码头	yu'zhu'ma'tou
蟹山	xie'shan
东山总站	dong'shan'zong'zhan
大东门	da'dong'men
农讲所	nong'jiang'suo
文德路	wen'de'lu
南关	nan'guan
海珠广场	hai'zhu'guang'chang
爱群大厦	ai'qun'da'sha
六二三路	liu'er'san'lu
市中医院	shi'zhong'yi'yuan
花地大道北	hua'di'da'dao'bei
芳村合兴苑	fang'cun'he'xing'yuan
东漖北路	dong'jiao'bei'lu
汾水	fen'shui
浣花路	huan'hua'lu
芳村客运站	fang'cun'ke'yun'zhan
龙溪大道东	long'xi'da'dao'dong
芳村花园南门总站	fang'cun'hua'yuan'nan'men'zong'zhan
芳村隧道口	fang'cun'sui'dao'kou
黄沙码头	huang'sha'ma'tou
南方大厦	nan'fang'da'sha
靖海路口	jing'hai'lu'kou
珠光路	zhu'guang'lu
北京南	bei'jing'nan
泮塘总站	pan'tang'zong'zhan
泮塘	pan'tang
多宝路口	duo'bao'lu'kou
恩宁路	en'ning'lu
和平中	he'ping'zhong
上九路	shang'jiu'lu
上九东	shang'jiu'dong
东升医院	dong'sheng'yi'yuan
人民中路	ren'min'zhong'lu
人民北路	ren'min'bei'lu
西门口	xi'men'kou
长寿西康王路口	chang'shou'xi'kang'wang'lu'kou
地铁长寿路站	di'tie'chang'shou'lu'zhan
宝华路口	bao'hua'lu'kou
逢源路	feng'yuan'lu
如意坊	ru'yi'fang
如意坊	ru'yi'fang
多宝路	duo'bao'lu
大德路	da'de'lu
省中医院	sheng'zhong'yi'yuan
解放南路口	jie'fang'nan'lu'kou
起义路口	qi'yi'lu'kou
东华西路	dong'hua'xi'lu
东华东路西	dong'hua'dong'lu'xi
东华东路	dong'hua'dong'lu
东山龟岗总站	dong'shan'gui'gang'zong'zhan
惠福路	hui'fu'lu
惠福西	hui'fu'xi
多宝路	duo'bao'lu
富力桃园总站	fu'li'tao'yuan'zong'zhan
西增路	xi'zeng'lu
富力环市西苑	fu'li'huan'shi'xi'yuan
彩虹戏院	cai'hong'xi'yuan
西华路	xi'hua'lu
大新路口	da'xin'lu'kou
一德西	yi'de'xi
一德中	yi'de'zhong
一德东	yi'de'dong
天字码头	tian'zi'ma'tou
文德南	wen'de'nan
东堤	dong'di
白云路	bai'yun'lu
长堤	zhang'di
人民南路	ren'min'nan'lu
和平新村	he'ping'xin'cun
南洲路口	nan'zhou'lu'kou
晓港湾	xiao'gang'wan
瑞南新村	rui'nan'xin'cun
五凤乡	wu'feng'xiang
东晓南路	dong'xiao'nan'lu
晓港新村	xiao'gang'xin'cun
云桂村	yun'gui'cun
基立村	ji'li'cun
解放中路	jie'fang'zhong'lu
迎宾馆	ying'bin'guan
解放北路口	jie'fang'bei'lu'kou
人民北路	ren'min'bei'lu
克山	ke'shan
市客运站总站	shi'ke'yun'zhan'zong'zhan
站南路	zhan'nan'lu
草暖公园	cao'nuan'gong'yuan
解放北路	jie'fang'bei'lu
盘福路	pan'fu'lu
前进路	qian'jin'lu
南洲名苑北	nan'zhou'ming'yuan'bei
黄沙	huang'sha
起义路	qi'yi'lu
公园前	gong'yuan'qian
越华路	yue'hua'lu
小北花圈	xiao'bei'hua'quan
小北	xiao'bei
黄花岗	huang'hua'gang
动物园	dong'wu'yuan
十九路军陵园	shi'jiu'lu'jun'ling'yuan
水荫路	shui'yin'lu
天河北公交总站	tian'he'bei'gong'jiao'zong'zhan
区庄立交西	qu'zhuang'li'jiao'xi
宝华路	bao'hua'lu
和平西	he'ping'xi
珠玑路	zhu'ji'lu
大沙头总站	da'sha'tou'zong'zhan
越秀南路	yue'xiu'nan'lu
万福东	wan'fu'dong
万福路	wan'fu'lu
财厅	cai'ting
中山五路	zhong'shan'wu'lu
省妇幼	sheng'fu'you
王圣堂	wang'sheng'tang
瑶台	yao'tai
北站	bei'zhan
沙涌	sha'yong
棠下	tang'xia
三元里大道中	san'yuan'li'da'dao'zhong
德康路	de'kang'lu
同德围	tong'de'wei
石槎路	shi'cha'lu
地铁石潭站	di'tie'shi'tan'zhan
石槎路	shi'cha'lu
桥东	qiao'dong
石槎路总站	shi'cha'lu'zong'zhan
市客运站	shi'ke'yun'zhan
吉祥路	ji'xiang'lu
白云路	bai'yun'lu
市三宫	shi'san'gong
华贵路口	hua'gui'lu'kou
龙津中路	long'jin'zhong'lu
龙津东路	long'jin'dong'lu
海珠广场	hai'zhu'guang'chang
南华中	nan'hua'zhong
珠江泳场	zhu'jiang'yong'chang
中大北门西	zhong'da'bei'men'xi
中大北门	zhong'da'bei'men
中信乐涛苑	zhong'xin'le'tao'yuan
下渡路口	xia'du'lu'kou
逸景路	yi'jing'lu
逸景翠园总站	yi'jing'cui'yuan'zong'zhan
华盛南路	hua'sheng'nan'lu
天雄布市	tian'xiong'bu'shi
海珠桥脚	hai'zhu'qiao'jiao
海珠广场	hai'zhu'guang'chang
海珠中路	hai'zhu'zhong'lu
大新西	da'xin'xi
南洲名苑	nan'zhou'ming'yuan
金碧花园	jin'bi'hua'yuan
新滘西路口	xin'jiao'xi'lu'kou
石溪	shi'xi
保利花园	bao'li'hua'yuan
纸厂	zhi'chang
珠江医院	zhu'jiang'yi'yuan
基建新村	ji'jian'xin'cun
凤凰新村	feng'huang'xin'cun
黄沙后道	huang'sha'hou'dao
黄沙大道	huang'sha'da'dao
荔湾湖公园西门	li'wan'hu'gong'yuan'xi'men
中山八路	zhong'shan'ba'lu
石路基	shi'lu'ji
荔湾路	li'wan'lu
彩虹桥	cai'hong'qiao
西华路尾	xi'hua'lu'wei
荔湾路口	li'wan'lu'kou
嘉鸿花园	jia'hong'hua'yuan
昌岗路总站	chang'gang'lu'zong'zhan
昌岗路口	chang'gang'lu'kou
南泰路西	nan'tai'lu'xi
仓边路	cang'bian'lu
华乐大厦	hua'le'da'sha
淘金北路	tao'jin'bei'lu
恒福路总站	heng'fu'lu'zong'zhan
省第二中医院	sheng'di'er'zhong'yi'yuan
海珠广场	hai'zhu'guang'chang
昌岗西路	chang'gang'xi'lu
体育中心东门	ti'yu'zhong'xin'dong'men
体育东路	ti'yu'dong'lu
天河邮局	tian'he'you'ju
冼村路北	xian'cun'lu'bei
冼村路中	xian'cun'lu'zhong
猎德	lie'de
猎德东	lie'de'dong
广州塔西	guang'zhou'ta'xi
赤岗塔	chi'gang'ta
新鸿花园	xin'hong'hua'yuan
广州大桥底	guang'zhou'da'qiao'di
珠江广场	zhu'jiang'guang'chang
东晓路	dong'xiao'lu
仲恺路	zhong'kai'lu
怡安花园朗晴居	yi'an'hua'yuan'lang'qing'ju
大元帅府	da'yuan'shuai'fu
万科四季花城总站	wan'ke'si'ji'hua'cheng'zong'zhan
浔峰山西路中	xun'feng'shan'xi'lu'zhong
悦峰三街路口	yue'feng'san'jie'lu'kou
地铁浔峰岗站	di'tie'xun'feng'gang'zhan
地铁横沙站	di'tie'heng'sha'zhan
金沙洲路	jin'sha'zhou'lu
金沙洲大桥西	jin'sha'zhou'da'qiao'xi
大沙头	da'sha'tou
二沙岛西总站	er'sha'dao'xi'zong'zhan
六榕路	liu'rong'lu
市一医院	shi'yi'yi'yuan
广卫路总站	guang'wei'lu'zong'zhan
教育路南	jiao'yu'lu'nan
地铁市二宫站	di'tie'shi'er'gong'zhan
赤岗	chi'gang
江海大道中	jiang'hai'da'dao'zhong
大塘	da'tang
龙潭村	long'tan'cun
龙潭村牌坊	long'tan'cun'pai'fang
新滘中路	xin'jiao'zhong'lu
新滘东路中	xin'jiao'dong'lu'zhong
赤沙路西	chi'sha'lu'xi
赤沙总站	chi'sha'zong'zhan
江南大道中	jiang'nan'da'dao'zhong
汾水小区总站	fen'shui'xiao'qu'zong'zhan
华贵路	hua'gui'lu
荣兴路	rong'xing'lu
茶漖小区	cha'jiao'xiao'qu
元岗总站	yuan'gang'zong'zhan
元岗路	yuan'gang'lu
元岗路	yuan'gang'lu
元岗横路	yuan'gang'heng'lu
云景花园	yun'jing'hua'yuan
京溪路	jing'xi'lu
犀牛路口	xi'niu'lu'kou
农林下路	nong'lin'xia'lu
东川路	dong'chuan'lu
凤凰岗	feng'huang'gang
执信中学	zhi'xin'zhong'xue
德星路总站	de'xing'lu'zong'zhan
华林寺	hua'lin'si
康王中路	kang'wang'zhong'lu
陈家祠	chen'jia'ci
珠江桥脚	zhu'jiang'qiao'jiao
南岸路	nan'an'lu
西场立交	xi'chang'li'jiao
西湾路	xi'wan'lu
黑山	hei'shan
西湾路	xi'wan'lu
西湾和苑	xi'wan'he'yuan
鹅掌坦	e'zhang'tan
同德乡	tong'de'xiang
上步村	shang'bu'cun
横滘	heng'jiao
泽德花苑	ze'de'hua'yuan
聚龙工业区	ju'long'gong'ye'qu
槎头	cha'tou
槎头	cha'tou
湖天货运站	hu'tian'huo'yun'zhan
凰岗路口	huang'gang'lu'kou
石潭西路口	shi'tan'xi'lu'kou
石丰路口	shi'feng'lu'kou
凰岗总站	huang'gang'zong'zhan
石榴岗	shi'liu'gang
台涌	tai'yong
石榴岗路西	shi'liu'gang'lu'xi
体育西横街路口	ti'yu'xi'heng'jie'lu'kou
冼村路南	xian'cun'lu'nan
桥中	qiao'zhong
芳村大道西	fang'cun'da'dao'xi
桥东小区	qiao'dong'xiao'qu
石围塘	shi'wei'tang
山村	shan'cun
花地	hua'di
芳村	fang'cun
下芳村	xia'fang'cun
大冲口	da'chong'kou
鹤洞新村	he'dong'xin'cun
广中码头	guang'zhong'ma'tou
真光中学	zhen'guang'zhong'xue
广州市培英中学	guang'zhou'shi'pei'ying'zhong'xue
白鹤洞	bai'he'dong
鹤洞路西	he'dong'lu'xi
西塱	xi'lang
麦村	mai'cun
渔尾大桥东	yu'wei'da'qiao'dong
花地大道	hua'di'da'dao
花地大道南	hua'di'da'dao'nan
沙尾桥	sha'wei'qiao
观海路	guan'hai'lu
岭南V谷总站	ling'nan'V'gu'zong'zhan
接龙里	jie'long'li
花蕾路	hua'lei'lu
桥中	qiao'zhong
天河南	tian'he'nan
大塘总站	da'tang'zong'zhan
兴盛路口	xing'sheng'lu'kou
解放北路总站	jie'fang'bei'lu'zong'zhan
越秀公园	yue'xiu'gong'yuan
三元里大道	san'yuan'li'da'dao
三元里	san'yuan'li
棠溪	tang'xi
三元里大道北	san'yuan'li'da'dao'bei
新市墟	xin'shi'xu
机场路	ji'chang'lu
黄石路口	huang'shi'lu'kou
联和	lian'he
鹤南	he'nan
冶金技校	ye'jin'ji'xiao
夏茅	xia'mao
夏茅客运站	xia'mao'ke'yun'zhan
大塱	da'lang
白沙湖	bai'sha'hu
广外附设外语学校	guang'wai'fu'she'wai'yu'xue'xiao
平沙	ping'sha
平沙南街	ping'sha'nan'jie
平沙村总站	ping'sha'cun'zong'zhan
景泰坑	jing'tai'keng
广园客运站	guang'yuan'ke'yun'zhan
广园新村	guang'yuan'xin'cun
交电新村	jiao'dian'xin'cun
中医学院	zhong'yi'xue'yuan
桂花岗	gui'hua'gang
大塘西总站	da'tang'xi'zong'zhan
广园中路	guang'yuan'zhong'lu
大坦沙总站	da'tan'sha'zong'zhan
育贤路口	yu'xian'lu'kou
桥中中路	qiao'zhong'zhong'lu
桥中中路南	qiao'zhong'zhong'lu'nan
仁威庙	ren'wei'miao
南村	nan'cun
华海大厦	hua'hai'da'sha
信和广场	xin'he'guang'chang
市八医院	shi'ba'yi'yuan
水荫路南	shui'yin'lu'nan
水荫横路口	shui'yin'heng'lu'kou
东莞庄一横路口	dong'guan'zhuang'yi'heng'lu'kou
电子五所社区	dian'zi'wu'suo'she'qu
东莞庄总站	dong'guan'zhuang'zong'zhan
广州大道中路口	guang'zhou'da'dao'zhong'lu'kou
大东门	da'dong'men
珠江嘉苑总站	zhu'jiang'jia'yuan'zong'zhan
沐陂西	mu'bei'xi
岑村小学	cen'cun'xiao'xue
岑村红花岗	cen'cun'hong'hua'gang
科韵路中	ke'yun'lu'zhong
阅江中路东	yue'jiang'zhong'lu'dong
宸悦路	chen'yue'lu
叁悦广场	san'yue'guang'chang
万胜围	wan'sheng'wei
琶洲村	pa'zhou'cun
琶洲塔公交总站	pa'zhou'ta'gong'jiao'zong'zhan
琶洲塔	pa'zhou'ta
地铁科韵路站	di'tie'ke'yun'lu'zhan
纸厂总站	zhi'chang'zong'zhan
纸厂邮局	zhi'chang'you'ju
广纸路	guang'zhi'lu
橡胶新村	xiang'jiao'xin'cun
宝岗大道南	bao'gang'da'dao'nan
西基东	xi'ji'dong
江南新村	jiang'nan'xin'cun
江南西路	jiang'nan'xi'lu
西苑	xi'yuan
流花路	liu'hua'lu
站前横路	zhan'qian'heng'lu
站前路	zhan'qian'lu
站南路	zhan'nan'lu
南部战区总医院	nan'bu'zhan'qu'zong'yi'yuan
流花公园	liu'hua'gong'yuan
庄头公园	zhuang'tou'gong'yuan
龙洞路口	long'dong'lu'kou
迎龙路	ying'long'lu
迎龙路	ying'long'lu
龙眼洞森林公园	long'yan'dong'sen'lin'gong'yuan
龙眼洞森林公园东	long'yan'dong'sen'lin'gong'yuan'dong
迎龙路北	ying'long'lu'bei
迎龙路	ying'long'lu
龙洞总站	long'dong'zong'zhan
南石西总站	nan'shi'xi'zong'zhan
南石路	nan'shi'lu
南泰路	nan'tai'lu
南泰路	nan'tai'lu
文化公园	wen'hua'gong'yuan
纸厂横马路	zhi'chang'heng'ma'lu
黄石路总站	huang'shi'lu'zong'zhan
新市	xin'shi
机场路岗贝路口	ji'chang'lu'gang'bei'lu'kou
白云区政务中心	bai'yun'qu'zheng'wu'zhong'xin
远景路	yuan'jing'lu
心谊路	xin'yi'lu
乐嘉路	le'jia'lu
机场立交北	ji'chang'li'jiao'bei
华工大	hua'gong'da
龙口西路北	long'kou'xi'lu'bei
云城南	yun'cheng'nan
芳信路总站	fang'xin'lu'zong'zhan
兴东路	xing'dong'lu
兴泰路	xing'tai'lu
松柏东街北	song'bai'dong'jie'bei
云苑新村	yun'yuan'xin'cun
云龙路南	yun'long'lu'nan
云龙路	yun'long'lu
盈翠华庭	ying'cui'hua'ting
广州体育馆南门	guang'zhou'ti'yu'guan'nan'men
地铁白云公园站	di'tie'bai'yun'gong'yuan'zhan
云城西路	yun'cheng'xi'lu
云港路	yun'gang'lu
云霄街总站	yun'xiao'jie'zong'zhan
云霄路	yun'xiao'lu
金信路	jin'xin'lu
松柏东街	song'bai'dong'jie
文德路总站	wen'de'lu'zong'zhan
白云路东	bai'yun'lu'dong
东湖新村	dong'hu'xin'cun
海印桥南	hai'yin'qiao'nan
三滘村	san'jiao'cun
沥滘	li'jiao
后滘村	hou'jiao'cun
南洲路	nan'zhou'lu
客轮船厂	ke'lun'chuan'chang
大沙村	da'sha'cun
大沙新村东街口	da'sha'xin'cun'dong'jie'kou
大沙村东	da'sha'cun'dong
救捞局	jiu'lao'ju
瀛洲路口	ying'zhou'lu'kou
瀛洲路	ying'zhou'lu
小洲村口	xiao'zhou'cun'kou
瀛洲生态公园	ying'zhou'sheng'tai'gong'yuan
小洲路东	xiao'zhou'lu'dong
北亭村大街	bei'ting'cun'da'jie
中部枢纽	zhong'bu'shu'niu
广大正门	guang'da'zheng'men
大学城科学中心总站	da'xue'cheng'ke'xue'zhong'xin'zong'zhan
沙溪	sha'xi
广州老年大学	guang'zhou'lao'nian'da'xue
晓港中马路	xiao'gang'zhong'ma'lu
星之光电器城	xing'zhi'guang'dian'qi'cheng
黄石路	huang'shi'lu
祥景花园	xiang'jing'hua'yuan
江夏	jiang'xia
黄石东路	huang'shi'dong'lu
云城东路北	yun'cheng'dong'lu'bei
体育花园	ti'yu'hua'yuan
柯子岭	ke'zi'ling
雕塑公园	diao'su'gong'yuan
老干大学	lao'gan'da'xue
下塘西路	xia'tang'xi'lu
童心南	tong'xin'nan
远安路	yuan'an'lu
珠江泳场总站	zhu'jiang'yong'chang'zong'zhan
黄石东	huang'shi'dong
古海岸公园	gu'hai'an'gong'yuan
东山口	dong'shan'kou
时代玫瑰园	shi'dai'mei'gui'yuan
黄边北路	huang'bian'bei'lu
云山诗意	yun'shan'shi'yi
黄边北路口	huang'bian'bei'lu'kou
天河公交场总站	tian'he'gong'jiao'chang'zong'zhan
龙洞北	long'dong'bei
广东外贸学校	guang'dong'wai'mao'xue'xiao
迎福路	ying'fu'lu
龙洞总站	long'dong'zong'zhan
天坤三路总站	tian'kun'san'lu'zong'zhan
天坤三路	tian'kun'san'lu
广氮花园	guang'dan'hua'yuan
广氮花园南	guang'dan'hua'yuan'nan
广园路	guang'yuan'lu
员村二横路	yuan'cun'er'heng'lu
员村生活区	yuan'cun'sheng'huo'qu
程界西	cheng'jie'xi
员村二横路南	yuan'cun'er'heng'lu'nan
临江大道	lin'jiang'da'dao
临江大道	lin'jiang'da'dao
猎德污水处理厂	lie'de'wu'shui'chu'li'chang
马场路南	ma'chang'lu'nan
花城大道东	hua'cheng'da'dao'dong
珠江公园南门	zhu'jiang'gong'yuan'nan'men
花城大道	hua'cheng'da'dao
五羊邨	wu'yang'cun
长城大厦	chang'cheng'da'sha
达道路	da'dao'lu
珠江宾馆	zhu'jiang'bin'guan
花城广场	hua'cheng'guang'chang
车陂路北	che'bei'lu'bei
华农大东北门	hua'nong'da'dong'bei'men
汇景北路总站	hui'jing'bei'lu'zong'zhan
白沙总站	bai'sha'zong'zhan
环洲二路	huan'zhou'er'lu
沙凤一路	sha'feng'yi'lu
沙凤	sha'feng
环洲三路	huan'zhou'san'lu
桃园西路	tao'yuan'xi'lu
东圃总站	dong'pu'zong'zhan
珠江医院总站	zhu'jiang'yi'yuan'zong'zhan
东湖路	dong'hu'lu
华穗路	hua'sui'lu
临江大道中	lin'jiang'da'dao'zhong
猎德码头	lie'de'ma'tou
临江大道东	lin'jiang'da'dao'dong
华洲路	hua'zhou'lu
华洲路口	hua'zhou'lu'kou
华洲路	hua'zhou'lu
华洲路中	hua'zhou'lu'zhong
土华	tu'hua
榕树头	rong'shu'tou
小洲总站	xiao'zhou'zong'zhan
中科院化学所	zhong'ke'yuan'hua'xue'suo
华南植物园南门	hua'nan'zhi'wu'yuan'nan'men
乐意居	le'yi'ju
兴华路	xing'hua'lu
三元里古庙	san'yuan'li'gu'miao
罗冲围总站	luo'chong'wei'zong'zhan
广园西路	guang'yuan'xi'lu
天平架	tian'ping'jia
洛溪新城	luo'xi'xin'cheng
上漖	shang'jiao
大石桥南	da'shi'qiao'nan
富丽	fu'li
祥和路口	xiang'he'lu'kou
朝阳东路	zhao'yang'dong'lu
星河湾	xing'he'wan
塘步西	tang'bu'xi
万博中心总站	wan'bo'zhong'xin'zong'zhan
西站	xi'zhan
西华路尾	xi'hua'lu'wei
白鹤洞村	bai'he'dong'cun
广船	guang'chuan
东塱	dong'lang
金宇花园	jin'yu'hua'yuan
紫荆道	zi'jing'dao
荷景路中	he'jing'lu'zhong
东沙街道办	dong'sha'jie'dao'ban
东沙工业园总站	dong'sha'gong'ye'yuan'zong'zhan
东沙大道南	dong'sha'da'dao'nan
海珠区妇幼	hai'zhu'qu'fu'you
越秀中路	yue'xiu'zhong'lu
东华南路总站	dong'hua'nan'lu'zong'zhan
金沙洲总站	jin'sha'zhou'zong'zhan
彩滨北路	cai'bin'bei'lu
横沙村	heng'sha'cun
环洲三路东	huan'zhou'san'lu'dong
城西花园	cheng'xi'hua'yuan
桥东小区总站	qiao'dong'xiao'qu'zong'zhan
白云山制药厂	bai'yun'shan'zhi'yao'chang
解放北路	jie'fang'bei'lu
海珠北路	hai'zhu'bei'lu
光塔路	guang'ta'lu
朝天路	chao'tian'lu
滘口客运站	jiao'kou'ke'yun'zhan
唐阁村总站	tang'ge'cun'zong'zhan
唐阁	tang'ge
市汽技校	shi'qi'ji'xiao
夏花二路	xia'hua'er'lu
小石马	xiao'shi'ma
石马	shi'ma
平沙路口	ping'sha'lu'kou
大朗北路口	da'lang'bei'lu'kou
大朗中路口	da'lang'zhong'lu'kou
外语外贸大学	wai'yu'wai'mao'da'xue
夏花一路	xia'hua'yi'lu
黄边三横路	huang'bian'san'heng'lu
黄边南	huang'bian'nan
乐得花园	le'de'hua'yuan
黄边南路	huang'bian'nan'lu
黄边	huang'bian
省戒毒基地	sheng'jie'du'ji'di
鹤边	he'bian
海珠南路	hai'zhu'nan'lu
广医一院总站	guang'yi'yi'yuan'zong'zhan
诗书路	shi'shu'lu
光塔路	guang'ta'lu
中山六路	zhong'shan'liu'lu
沥滘总站	li'jiao'zong'zhan
车陂高架桥侧	che'bei'gao'jia'qiao'ce
机场路总站	ji'chang'lu'zong'zhan
黄村立交	huang'cun'li'jiao
和平东	he'ping'dong
万福西	wan'fu'xi
海印桥总站	hai'yin'qiao'zong'zhan
广佛路口	guang'fu'lu'kou
兴民路总站	xing'min'lu'zong'zhan
华成路口	hua'cheng'lu'kou
西湾路总站	xi'wan'lu'zong'zhan
机务段路口	ji'wu'duan'lu'kou
华夏路北	hua'xia'lu'bei
广视宾馆	guang'shi'bin'guan
市胸科医院	shi'xiong'ke'yi'yuan
横枝岗	heng'zhi'gang
横枝岗路北	heng'zhi'gang'lu'bei
云台花园	yun'tai'hua'yuan
白云仙馆	bai'yun'xian'guan
麓湖公园	lu'hu'gong'yuan
解放南路	jie'fang'nan'lu
南漖村	nan'jiao'cun
玉兰路中	yu'lan'lu'zhong
玉兰路南	yu'lan'lu'nan
东西路	dong'xi'lu
乐意居花园总站	le'yi'ju'hua'yuan'zong'zhan
豪贤路	hao'xian'lu
德政中路	de'zheng'zhong'lu
永泰客运站	yong'tai'ke'yun'zhan
东平南路	dong'ping'nan'lu
黄草埔	huang'cao'bu
文盛庄路	wen'sheng'zhuang'lu
协和神学院	xie'he'shen'xue'yuan
东平广场	dong'ping'guang'chang
东平市场	dong'ping'shi'chang
东平北路	dong'ping'bei'lu
东平北路	dong'ping'bei'lu
东平总站	dong'ping'zong'zhan
集贤苑路口	ji'xian'yuan'lu'kou
集贤庄	ji'xian'zhuang
新厅街	xin'ting'jie
大塘路口	da'tang'lu'kou
卷烟一厂	juan'yan'yi'chang
赤岗路	chi'gang'lu
花地大道中	hua'di'da'dao'zhong
龙溪立交南	long'xi'li'jiao'nan
东漖街	dong'jiao'jie
东漖怀宁坊	dong'jiao'huai'ning'fang
芳村花园总站	fang'cun'hua'yuan'zong'zhan
坑口地铁站	keng'kou'di'tie'zhan
康乃馨花园	kang'nai'xin'hua'yuan
同德围总站	tong'de'wei'zong'zhan
花地大道	hua'di'da'dao
翠竹苑	cui'zhu'yuan
芳村西塱总站	fang'cun'xi'lang'zong'zhan
水秀一路总站	shui'xiu'yi'lu'zong'zhan
水秀一路西	shui'xiu'yi'lu'xi
水秀一路	shui'xiu'yi'lu
水秀一路中	shui'xiu'yi'lu'zhong
芳村花园北门	fang'cun'hua'yuan'bei'men
大策	da'ce
联桂北	lian'gui'bei
中山七路	zhong'shan'qi'lu
西门口	xi'men'kou
动物园总站	dong'wu'yuan'zong'zhan
东漖南路	dong'jiao'nan'lu
东漖镇	dong'jiao'zhen
侨诚花园总站	qiao'cheng'hua'yuan'zong'zhan
江晓路口	jiang'xiao'lu'kou
龙归永兴村总站	long'gui'yong'xing'cun'zong'zhan
龙河中路	long'he'zhong'lu
永兴村口	yong'xing'cun'kou
龙归路口	long'gui'lu'kou
东平路口	dong'ping'lu'kou
地铁白云东平站	di'tie'bai'yun'dong'ping'zhan
广从路	guang'cong'lu
永泰客运站	yong'tai'ke'yun'zhan
广州电大麓湖校区	guang'zhou'dian'da'lu'hu'xiao'qu
麓景路	lu'jing'lu
环市中路口	huan'shi'zhong'lu'kou
龙河中路口	long'he'zhong'lu'kou
集贤苑教师新村	ji'xian'yuan'jiao'shi'xin'cun
百顺南路	bai'shun'nan'lu
集贤苑教师新村	ji'xian'yuan'jiao'shi'xin'cun
元下田村	yuan'xia'tian'cun
福泰西路	fu'tai'xi'lu
东山总站	dong'shan'zong'zhan
丛云路南	cong'yun'lu'nan
财税学院	cai'shui'xue'yuan
武警一中队	wu'jing'yi'zhong'dui
云山居	yun'shan'ju
天慧路总站	tian'hui'lu'zong'zhan
天慧路北	tian'hui'lu'bei
天慧路中	tian'hui'lu'zhong
天慧路	tian'hui'lu
思成路	si'cheng'lu
华观路东	hua'guan'lu'dong
华观路中	hua'guan'lu'zhong
东山广场总站	dong'shan'guang'chang'zong'zhan
岑村总站	cen'cun'zong'zhan
体育西路	ti'yu'xi'lu
维多利广场	wei'duo'li'guang'chang
康王南路	kang'wang'nan'lu
吉祥道	ji'xiang'dao
地铁洛溪站	di'tie'luo'xi'zhan
新浦路口	xin'pu'lu'kou
北环路	bei'huan'lu
洛溪新城总站	luo'xi'xin'cheng'zong'zhan
洛涛居	luo'tao'ju
洛城中学	luo'cheng'zhong'xue
如意路	ru'yi'lu
粤溪村	yue'xi'cun
同德围总站	tong'de'wei'zong'zhan
芳村大道西总站	fang'cun'da'dao'xi'zong'zhan
元岗路	yuan'gang'lu
元岗村	yuan'gang'cun
地铁龙洞站	di'tie'long'dong'zhan
广汕一路	guang'shan'yi'lu
榄元村	lan'yuan'cun
柯木塱	ke'mu'lang
广汕一路东	guang'shan'yi'lu'dong
省电校	sheng'dian'xiao
地铁高塘石站	di'tie'gao'tang'shi'zhan
高塘工业区	gao'tang'gong'ye'qu
高塘石东	gao'tang'shi'dong
广汕二路	guang'shan'er'lu
华沙村	hua'sha'cun
地铁黄陂站	di'tie'huang'po'zhan
长安	chang'an
万龙路口	wan'long'lu'kou
广汕路总站	guang'shan'lu'zong'zhan
班岭村	ban'ling'cun
元岗横路东	yuan'gang'heng'lu'dong
动物园总站	dong'wu'yuan'zong'zhan
华美路	hua'mei'lu
华美学校	hua'mei'xue'xiao
欧岗村	ou'gang'cun
沙东新村	sha'dong'xin'cun
凤凰公司	feng'huang'gong'si
楼阁村	lou'ge'cun
渔东路	yu'dong'lu
渔北路中	yu'bei'lu'zhong
渔北路	yu'bei'lu
渔沙坦	yu'sha'tan
渔沙坦总站	yu'sha'tan'zong'zhan
龙洞东路	long'dong'dong'lu
龙洞东路	long'dong'dong'lu
龙洞东路中	long'dong'dong'lu'zhong
龙洞北路东	long'dong'bei'lu'dong
渔兴路口	yu'xing'lu'kou
渔兴路	yu'xing'lu
渔中路口	yu'zhong'lu'kou
旺岗村	wang'gang'cun
渔沙坦总站	yu'sha'tan'zong'zhan
一德西	yi'de'xi
保利红棉花园	bao'li'hong'mian'hua'yuan
南汉二陵博物馆	nan'han'er'ling'bo'wu'guan
广大附中	guang'da'fu'zhong
省中医院大学城医院	sheng'zhong'yi'yuan'da'xue'cheng'yi'yuan
中心南大街	zhong'xin'nan'da'jie
广工一路北	guang'gong'yi'lu'bei
综合商业南区	zong'he'shang'ye'nan'qu
华工	hua'gong
华工生活区	hua'gong'sheng'huo'qu
广药路	guang'yao'lu
大学城广中医总站	da'xue'cheng'guang'zhong'yi'zong'zhan
大新路	da'xin'lu
沃野鸿天广场总站	wo'ye'hong'tian'guang'chang'zong'zhan
叠景路口	die'jing'lu'kou
叠景路	die'jing'lu
沥滘路西	li'jiao'lu'xi
南天商业城	nan'tian'shang'ye'cheng
洛溪桥底	luo'xi'qiao'di
海珠儿童公园	hai'zhu'er'tong'gong'yuan
西场总站	xi'chang'zong'zhan
天河客运站	tian'he'ke'yun'zhan
沙溪大道东总站	sha'xi'da'dao'dong'zong'zhan
珠江花园	zhu'jiang'hua'yuan
地铁沙溪站	di'tie'sha'xi'zhan
地铁沙溪站	di'tie'sha'xi'zhan
沙溪商贸城	sha'xi'shang'mao'cheng
沙溪村牌坊	sha'xi'cun'pai'fang
沙溪村	sha'xi'cun
海珠路	hai'zhu'lu
珠光路总站	zhu'guang'lu'zong'zhan
江南新村	jiang'nan'xin'cun
南方茶叶市场总站	nan'fang'cha'ye'shi'chang'zong'zhan
景泰坑总站	jing'tai'keng'zong'zhan
河田西路	he'tian'xi'lu
赤岗北路	chi'gang'bei'lu
赤岗北路	chi'gang'bei'lu
赤岗	chi'gang
童心北	tong'xin'bei
文化公园总站	wen'hua'gong'yuan'zong'zhan
东山总站	dong'shan'zong'zhan
鹤洞	he'dong
棠安路	tang'an'lu
康王北路	kang'wang'bei'lu
茶滘路总站	cha'jiao'lu'zong'zhan
茶滘路	cha'jiao'lu
中山八路	zhong'shan'ba'lu
花城广场西总站	hua'cheng'guang'chang'xi'zong'zhan
珠江西路南	zhu'jiang'xi'lu'nan
南悦花苑	nan'yue'hua'yuan
南悦花苑总站	nan'yue'hua'yuan'zong'zhan
三元里大道口	san'yuan'li'da'dao'kou
横枝岗	heng'zhi'gang
省银行医院	sheng'yin'hang'yi'yuan
横枝岗路口	heng'zhi'gang'lu'kou
恒福路	heng'fu'lu
西坑	xi'keng
西坑	xi'keng
南田路	nan'tian'lu
永福路	yong'fu'lu
南田西	nan'tian'xi
珠江帝景苑总站	zhu'jiang'di'jing'yuan'zong'zhan
堑口码头	qian'kou'ma'tou
浣花东路	huan'hua'dong'lu
芳村小学	fang'cun'xiao'xue
花溪路口	hua'xi'lu'kou
芳和花园总站	fang'he'hua'yuan'zong'zhan
芳村花园	fang'cun'hua'yuan
南田路	nan'tian'lu
荷景路西	he'jing'lu'xi
西塱社区总站	xi'lang'she'qu'zong'zhan
丽江花园正门	li'jiang'hua'yuan'zheng'men
丽江花园	li'jiang'hua'yuan
半岛花园总站	ban'dao'hua'yuan'zong'zhan
北村	bei'cun
北村路	bei'cun'lu
盐步路口	yan'bu'lu'kou
大转弯	da'zhuan'wan
嘉洲广场	jia'zhou'guang'chang
宏威路口	hong'wei'lu'kou
黄岐城区	huang'qi'cheng'qu
广佛路东	guang'fu'lu'dong
革新路总站	ge'xin'lu'zong'zhan
云苑新村	yun'yuan'xin'cun
丽江花园	li'jiang'hua'yuan
新园路	xin'yuan'lu
丽江路口	li'jiang'lu'kou
如意三马路	ru'yi'san'ma'lu
建设大马路	jian'she'da'ma'lu
白云山制药厂	bai'yun'shan'zhi'yao'chang
省旅游学校	sheng'lyu'you'xue'xiao
白云山制药厂	bai'yun'shan'zhi'yao'chang
颐和山庄	yi'he'shan'zhuang
永泰新村	yong'tai'xin'cun
马务	ma'wu
小坪	xiao'ping
榕溪	rong'xi
石井	shi'jing
石井中学	shi'jing'zhong'xue
庆丰财智广场	qing'feng'cai'zhi'guang'chang
石井文化广场	shi'jing'wen'hua'guang'chang
凰岗凤凰大道东	huang'gang'feng'huang'da'dao'dong
市医药职业学校	shi'yi'yao'zhi'ye'xue'xiao
凰岗总站	huang'gang'zong'zhan
庆丰广场	qing'feng'guang'chang
小坪立交桥	xiao'ping'li'jiao'qiao
均禾工业区总站	jun'he'gong'ye'qu'zong'zhan
大布路	da'bu'lu
清湖马田街	qing'hu'ma'tian'jie
清湖村委	qing'hu'cun'wei
清湖村口	qing'hu'cun'kou
均和东	jun'he'dong
均和墟	jun'he'xu
石马村口	shi'ma'cun'kou
石马南	shi'ma'nan
珠岛花园总站	zhu'dao'hua'yuan'zong'zhan
珠岛花园	zhu'dao'hua'yuan
双桥公园	shuang'qiao'gong'yuan
坦尾路	tan'wei'lu
海角红楼	hai'jiao'hong'lou
大石桥北	da'shi'qiao'bei
五洲装饰材料城	wu'zhou'zhuang'shi'cai'liao'cheng
南大路口	nan'da'lu'kou
万博中心	wan'bo'zhong'xin
锦绣香江	jin'xiu'xiang'jiang
锦绣香江北门	jin'xiu'xiang'jiang'bei'men
地铁汉溪长隆C站	di'tie'han'xi'zhang'long'C'zhan
南国奥林匹克花园	nan'guo'ao'lin'pi'ke'hua'yuan
地铁汉溪长隆A站	di'tie'han'xi'zhang'long'A'zhan
华南碧桂园	hua'nan'bi'gui'yuan
翰景路	han'jing'lu
科技东街北门	ke'ji'dong'jie'bei'men
华景新城西	hua'jing'xin'cheng'xi
大江直街南	da'jiang'zhi'jie'nan
大江直街北	da'jiang'zhi'jie'bei
大江苑	da'jiang'yuan
海幢码头	hai'chuang'ma'tou
同福西路	tong'fu'xi'lu
洲头咀公园	zhou'tou'ju'gong'yuan
滨江西路	bin'jiang'xi'lu
滨江西路	bin'jiang'xi'lu
广州大桥南	guang'zhou'da'qiao'nan
白天鹅花园总站	bai'tian'e'hua'yuan'zong'zhan
沙面新城	sha'mian'xin'cheng
石中路口	shi'zhong'lu'kou
黄岐办事处	huang'qi'ban'shi'chu
鄱阳路	po'yang'lu
宏威路	hong'wei'lu
龙口西总站	long'kou'xi'zong'zhan
泽德花苑总站	ze'de'hua'yuan'zong'zhan
南湖总站	nan'hu'zong'zhan
三九脑科医院	san'jiu'nao'ke'yi'yuan
沙太南路	sha'tai'nan'lu
天虹宾馆	tian'hong'bin'guan
南华工商学院	nan'hua'gong'shang'xue'yuan
侨乐新村	qiao'le'xin'cun
天平架	tian'ping'jia
动物园南门	dong'wu'yuan'nan'men
体育西路南	ti'yu'xi'lu'nan
琶洲塔公园	pa'zhou'ta'gong'yuan
杨青村	yang'qing'cun
黄埔村	huang'pu'cun
新港东路东	xin'gang'dong'lu'dong
新洲科技园	xin'zhou'ke'ji'yuan
新洲前	xin'zhou'qian
新洲码头	xin'zhou'ma'tou
新洲总站	xin'zhou'zong'zhan
红线女中心	hong'xian'nyu'zhong'xin
马场路中	ma'chang'lu'zhong
石牌西路	shi'pai'xi'lu
海欣街	hai'xin'jie
京溪路口	jing'xi'lu'kou
员村总站	yuan'cun'zong'zhan
林和西路口	lin'he'xi'lu'kou
林和西横路	lin'he'xi'heng'lu
岗贝路东	gang'bei'lu'dong
岗贝路	gang'bei'lu
上步大道	shang'bu'da'dao
上步总站	shang'bu'zong'zhan
沥滘总站	li'jiao'zong'zhan
柯子岭总站	ke'zi'ling'zong'zhan
站前横路口	zhan'qian'heng'lu'kou
芳村客运站	fang'cun'ke'yun'zhan
越秀桥	yue'xiu'qiao
越秀北路	yue'xiu'bei'lu
横枝岗总站	heng'zhi'gang'zong'zhan
富康路	fu'kang'lu
南泰路	nan'tai'lu
广园新村总站	guang'yuan'xin'cun'zong'zhan
景泰直街	jing'tai'zhi'jie
沥滘总站	li'jiao'zong'zhan
振兴路中	zhen'xing'lu'zhong
大基头总站	da'ji'tou'zong'zhan
石榴岗总站	shi'liu'gang'zong'zhan
泰康路	tai'kang'lu
景云路	jing'yun'lu
市红会医院北门总站	shi'hong'hui'yi'yuan'bei'men'zong'zhan
水荫路总站	shui'yin'lu'zong'zhan
市慈善医院	shi'ci'shan'yi'yuan
百花路	bai'hua'lu
海珠广场总站	hai'zhu'guang'chang'zong'zhan
华景北路口	hua'jing'bei'lu'kou
华景新城总站	hua'jing'xin'cheng'zong'zhan
华景北路东	hua'jing'bei'lu'dong
枫叶路	feng'ye'lu
枫叶路口	feng'ye'lu'kou
潭村总站	tan'cun'zong'zhan
宝鸭北路	bao'ya'bei'lu
少管所	shao'guan'suo
风度路口	feng'du'lu'kou
张村	zhang'cun
东旺市场	dong'wang'shi'chang
增槎路北	zeng'cha'lu'bei
云城西路南	yun'cheng'xi'lu'nan
云城西路中	yun'cheng'xi'lu'zhong
润云路口	run'yun'lu'kou
齐富路中	qi'fu'lu'zhong
齐富路	qi'fu'lu
齐富路东	qi'fu'lu'dong
先烈南路	xian'lie'nan'lu
南方医科大学	nan'fang'yi'ke'da'xue
白云农批市场	bai'yun'nong'pi'shi'chang
犀牛角村总站	xi'niu'jiao'cun'zong'zhan
坦尾总站	tan'wei'zong'zhan
三骏市场	san'jun'shi'chang
白沙公交场	bai'sha'gong'jiao'chang
兴联	xing'lian
白沙社区	bai'sha'she'qu
沙溪	sha'xi
泌冲	mi'chong
建设大道	jian'she'da'dao
教育路口	jiao'yu'lu'kou
沙面新城	sha'mian'xin'cheng
康王路总站	kang'wang'lu'zong'zhan
新滘东路总站	xin'jiao'dong'lu'zong'zhan
赤沙公园	chi'sha'gong'yuan
恒宝广场总站	heng'bao'guang'chang'zong'zhan
步漖村	bu'jiao'cun
增南路口	zeng'nan'lu'kou
增滘村	zeng'jiao'cun
东石牌坊	dong'shi'pai'fang
龙溪中路	long'xi'zhong'lu
龙溪西路	long'xi'xi'lu
裕海路	yu'hai'lu
迎宾路口	ying'bin'lu'kou
花博大道	hua'bo'da'dao
广州花卉博览园总站	guang'zhou'hua'hui'bo'lan'yuan'zong'zhan
东漖教师新村	dong'jiao'jiao'shi'xin'cun
大坦沙污水处理厂	da'tan'sha'wu'shui'chu'li'chang
黄埔体育馆南门	huang'pu'ti'yu'guan'nan'men
护林路	hu'lin'lu
瑞东花园	rui'dong'hua'yuan
黄埔广附实验学校	huang'pu'guang'fu'shi'yan'xue'xiao
石化生活区	shi'hua'sheng'huo'qu
三元宫	san'yuan'gong
应元路	ying'yuan'lu
海联路	hai'lian'lu
凤凰村	feng'huang'cun
祈乐苑	qi'le'yuan
怡乐路南	yi'le'lu'nan
南浦桥南	nan'pu'qiao'nan
地铁南浦站	di'tie'nan'pu'zhan
广州碧桂园	guang'zhou'bi'gui'yuan
东乡村东	dong'xiang'cun'dong
东乡村西	dong'xiang'cun'xi
西二村口	xi'er'cun'kou
浦华路西	pu'hua'lu'xi
南浦敏捷金月湾	nan'pu'min'jie'jin'yue'wan
锦绣半岛西区	jin'xiu'ban'dao'xi'qu
南浦岛总站	nan'pu'dao'zong'zhan
地铁洛溪站	di'tie'luo'xi'zhan
怡乐路	yi'le'lu
西村总站	xi'cun'zong'zhan
同康路	tong'kang'lu
同康路东	tong'kang'lu'dong
石潭路	shi'tan'lu
石潭路	shi'tan'lu
风度路	feng'du'lu
张村	zhang'cun
石潭西路北	shi'tan'xi'lu'bei
庆丰	qing'feng
红星桥	hong'xing'qiao
朝阳路口	zhao'yang'lu'kou
地铁亭岗站	di'tie'ting'gang'zhan
滘心工业区	jiao'xin'gong'ye'qu
滘心村口	jiao'xin'cun'kou
朝阳开发区	zhao'yang'kai'fa'qu
鸦岗路口	ya'gang'lu'kou
石井鸦岗总站	shi'jing'ya'gang'zong'zhan
笔村立交南	bi'cun'li'jiao'nan
黄埔水库	huang'pu'shui'ku
储运公司	chu'yun'gong'si
开发区立交桥北	kai'fa'qu'li'jiao'qiao'bei
康南路口	kang'nan'lu'kou
小迳村	xiao'jing'cun
南岗沧头	nan'gang'cang'tou
沙村	sha'cun
太平洋工业区	tai'ping'yang'gong'ye'qu
新康花园北门	xin'kang'hua'yuan'bei'men
新好景	xin'hao'jing
群星花园	qun'xing'hua'yuan
新塘总站	xin'tang'zong'zhan
广虎站	guang'hu'zhan
丽康居	li'kang'ju
同德围总站	tong'de'wei'zong'zhan
石牌东路北	shi'pai'dong'lu'bei
石牌东路南	shi'pai'dong'lu'nan
南箕路总站	nan'ji'lu'zong'zhan
邓岗小区	deng'gang'xiao'qu
纸厂市场	zhi'chang'shi'chang
工业大道口	gong'ye'da'dao'kou
宝业路	bao'ye'lu
宝业路口	bao'ye'lu'kou
法政路	fa'zheng'lu
燕翔路	yan'xiang'lu
芳村丰年路总站	fang'cun'feng'nian'lu'zong'zhan
白云花园	bai'yun'hua'yuan
机务段总站	ji'wu'duan'zong'zhan
机务大街	ji'wu'da'jie
滨江东路总站	bin'jiang'dong'lu'zong'zhan
聚德路	ju'de'lu
大塘总站	da'tang'zong'zhan
警察学校	jing'cha'xue'xiao
健乐医院	jian'le'yi'yuan
石井庆丰总站	shi'jing'qing'feng'zong'zhan
石基村口	shi'ji'cun'kou
黄埔村南村口	huang'pu'cun'nan'cun'kou
琶洲石基村总站	pa'zhou'shi'ji'cun'zong'zhan
纸厂横马路	zhi'chang'heng'ma'lu
善贤路	shan'xian'lu
浔峰山东路北	xun'feng'shan'dong'lu'bei
金名都	jin'ming'dou
洲村	zhou'cun
洲村市场	zhou'cun'shi'chang
草场	cao'chang
草场工业区	cao'chang'gong'ye'qu
丰岗收费站	feng'gang'shou'fei'zhan
丰岗	feng'gang
流潮	liu'chao
南海管业城	nan'hai'guan'ye'cheng
佛山模具城	fo'shan'mu'ju'cheng
下亨田村	xia'heng'tian'cun
河村口	he'cun'kou
旗峰小学	qi'feng'xiao'xue
里水汽车客运站	li'shui'qi'che'ke'yun'zhan
银印	yin'yin
邓岗	deng'gang
里水桥南	li'shui'qiao'nan
新天地广场	xin'tian'di'guang'chang
得金工业区路口	de'jin'gong'ye'qu'lu'kou
白岗市场	bai'gang'shi'chang
和顺车站总站	he'shun'che'zhan'zong'zhan
甘蕉	gan'jiao
石井潭村总站	shi'jing'tan'cun'zong'zhan
南方大厦总站	nan'fang'da'sha'zong'zhan
南洲花园	nan'zhou'hua'yuan
南洲北路	nan'zhou'bei'lu
盈丰路	ying'feng'lu
南洲北路总站	nan'zhou'bei'lu'zong'zhan
瑞宝小学	rui'bao'xiao'xue
同德围总站	tong'de'wei'zong'zhan
金湖雅苑总站	jin'hu'ya'yuan'zong'zhan
光大花园	guang'da'hua'yuan
江南大道南	jiang'nan'da'dao'nan
江燕路口	jiang'yan'lu'kou
汇侨南路	hui'qiao'nan'lu
汇侨新城总站	hui'qiao'xin'cheng'zong'zhan
黄石北路口	huang'shi'bei'lu'kou
黄石东总站	huang'shi'dong'zong'zhan
平云路北	ping'yun'lu'bei
平云路中	ping'yun'lu'zhong
员村一横路	yuan'cun'yi'heng'lu
员村一横路总站	yuan'cun'yi'heng'lu'zong'zhan
白云山中药厂	bai'yun'shan'zhong'yao'chang
金湖住宅区	jin'hu'zhu'zhai'qu
金盘岭教练场	jin'pan'ling'jiao'lian'chang
公用事业技校	gong'yong'shi'ye'ji'xiao
市交通技工学校	shi'jiao'tong'ji'gong'xue'xiao
友好老年公寓	you'hao'lao'nian'gong'yu
寿星大厦	shou'xing'da'sha
友好医院	you'hao'yi'yuan
大源	da'yuan
大源北	da'yuan'bei
茶山庄	cha'shan'zhuang
百足桥	bai'zu'qiao
大源路北	da'yuan'lu'bei
上南村	shang'nan'cun
一一五中学	yi'yi'wu'zhong'xue
罗洞村口	luo'dong'cun'kou
米龙村	mi'long'cun
太和中路	tai'he'zhong'lu
太和文化广场	tai'he'wen'hua'guang'chang
太和	tai'he
太和总站	tai'he'zong'zhan
太和南路	tai'he'nan'lu
南洲北路	nan'zhou'bei'lu
建设六马路	jian'she'liu'ma'lu
南燕路	nan'yan'lu
石榴岗总站	shi'liu'gang'zong'zhan
新滘东路东	xin'jiao'dong'lu'dong
赤沙牌坊	chi'sha'pai'fang
聚德西路	ju'de'xi'lu
嘉禾	jia'he
市交校	shi'jiao'xiao
望岗	wang'gang
七星岗路东	qi'xing'gang'lu'dong
七星岗路	qi'xing'gang'lu
七星岗	qi'xing'gang
罗岗村	luo'gang'cun
罗岗市场	luo'gang'shi'chang
罗岗村委	luo'gang'cun'wei
广信中学	guang'xin'zhong'xue
七星岗总站	qi'xing'gang'zong'zhan
鹤南	he'nan
小洲	xiao'zhou
小洲村	xiao'zhou'cun
外环西路总站	wai'huan'xi'lu'zong'zhan
瑞宝乡总站	rui'bao'xiang'zong'zhan
江泰路	jiang'tai'lu
江南大道南	jiang'nan'da'dao'nan
江泰路口	jiang'tai'lu'kou
红星平安大道南	hong'xing'ping'an'da'dao'nan
红星工业路南	hong'xing'gong'ye'lu'nan
红星工业路北	hong'xing'gong'ye'lu'bei
浮山大街口	fu'shan'da'jie'kou
石井红星村总站	shi'jing'hong'xing'cun'zong'zhan
地铁小坪站	di'tie'xiao'ping'zhan
七星岗路口	qi'xing'gang'lu'kou
新科工业区	xin'ke'gong'ye'qu
科甲水	ke'jia'shui
嘉禾长湴	jia'he'zhang'ban
长湴工业街	zhang'ban'gong'ye'jie
长湴工业街口	zhang'ban'gong'ye'jie'kou
嘉禾长湴总站	jia'he'zhang'ban'zong'zhan
芳兴路	fang'xing'lu
永盛市场	yong'sheng'shi'chang
土特产批发市场	tu'te'chan'pi'fa'shi'chang
中南花园	zhong'nan'hua'yuan
洞庭路	dong'ting'lu
大转弯夹板城	da'zhuan'wan'jia'ban'cheng
联安	lian'an
虎榜路口	hu'bang'lu'kou
盐步医院	yan'bu'yi'yuan
盐步中学	yan'bu'zhong'xue
直街社区	zhi'jie'she'qu
河西大道东	he'xi'da'dao'dong
华夏北	hua'xia'bei
碧翠华庭	bi'cui'hua'ting
盐步大道北	yan'bu'da'dao'bei
虎榜市场	hu'bang'shi'chang
三眼桥	san'yan'qiao
雅居蓝湾	ya'ju'lan'wan
穗盐路总站	sui'yan'lu'zong'zhan
汇彩路口	hui'cai'lu'kou
黄埔大道东	huang'pu'da'dao'dong
鱼珠总站	yu'zhu'zong'zhan
新洲码头	xin'zhou'ma'tou
晓港湾	xiao'gang'wan
盈丰路	ying'feng'lu
北山村总站	bei'shan'cun'zong'zhan
北山村	bei'shan'cun
仑头总站	lun'tou'zong'zhan
中华姓名博物馆	zhong'hua'xing'ming'bo'wu'guan
环村南路	huan'cun'nan'lu
广州大道南路口	guang'zhou'da'dao'nan'lu'kou
聚德西路口	ju'de'xi'lu'kou
龙潭立交西	long'tan'li'jiao'xi
小坪桥口	xiao'ping'qiao'kou
环滘工业区	huan'jiao'gong'ye'qu
环滘村路口	huan'jiao'cun'lu'kou
环滘村委会	huan'jiao'cun'wei'hui
环滘村总站	huan'jiao'cun'zong'zhan
环滘旧桥头	huan'jiao'jiu'qiao'tou
科华路	ke'hua'lu
农科院兽医研究所	nong'ke'yuan'shou'yi'yan'jiu'suo
四十七中汇景实验学校	si'shi'qi'zhong'hui'jing'shi'yan'xue'xiao
四十七中汇景实验学校北门	si'shi'qi'zhong'hui'jing'shi'yan'xue'xiao'bei'men
陈家祠总站	chen'jia'ci'zong'zhan
土华村	tu'hua'cun
土华路东	tu'hua'lu'dong
土华总站	tu'hua'zong'zhan
广州市儿童公园总站	guang'zhou'shi'er'tong'gong'yuan'zong'zhan
石井大道	shi'jing'da'dao
石井大道南	shi'jing'da'dao'nan
石井大道	shi'jing'da'dao
石井大道	shi'jing'da'dao
石井大道	shi'jing'da'dao
白云湖公园西湖北门	bai'yun'hu'gong'yuan'xi'hu'bei'men
滘心路口	jiao'xin'lu'kou
滘心市场	jiao'xin'shi'chang
滘心小学	jiao'xin'xiao'xue
滘心村总站	jiao'xin'cun'zong'zhan
晓港湾	xiao'gang'wan
南京路小区	nan'jing'lu'xiao'qu
西增路口	xi'zeng'lu'kou
黄边横路	huang'bian'heng'lu
黄边北路中	huang'bian'bei'lu'zhong
启德路总站	qi'de'lu'zong'zhan
奕西	yi'xi
禾仰	he'yang
保利心语花园总站	bao'li'xin'yu'hua'yuan'zong'zhan
保丰路	bao'feng'lu
港口路北	gang'kou'lu'bei
平洲立交	ping'zhou'li'jiao
太平路口	tai'ping'lu'kou
桂城长者颐乐中心	gui'cheng'zhang'zhe'yi'le'zhong'xin
平洲宾馆	ping'zhou'bin'guan
平洲玉器街	ping'zhou'yu'qi'jie
省人民医院平洲分院	sheng'ren'min'yi'yuan'ping'zhou'fen'yuan
平南市场	ping'nan'shi'chang
蓬涌	peng'yong
平西路口	ping'xi'lu'kou
平洲总站	ping'zhou'zong'zhan
南海第二人民医院	nan'hai'di'er'ren'min'yi'yuan
桂城交管所	gui'cheng'jiao'guan'suo
南洲北路总站	nan'zhou'bei'lu'zong'zhan
悦峰三街	yue'feng'san'jie
春满街	chun'man'jie
沙面新城	sha'mian'xin'cheng
黄岐行政服务中心	huang'qi'xing'zheng'fu'wu'zhong'xin
嘉洲花园西门	jia'zhou'hua'yuan'xi'men
北村闸	bei'cun'zha
名雅花园	ming'ya'hua'yuan
湖洲	hu'zhou
沙涌	sha'yong
上沙村	shang'sha'cun
绿地香树花城总站	lyu'di'xiang'shu'hua'cheng'zong'zhan
环洲三路西	huan'zhou'san'lu'xi
员村总站	yuan'cun'zong'zhan
花地大道南总站	hua'di'da'dao'nan'zong'zhan
黄岐第一城总站	huang'qi'di'yi'cheng'zong'zhan
黄岐百货大厦	huang'qi'bai'huo'da'sha
黄海路	huang'hai'lu
大石	da'shi
礼村	li'cun
香江动物园	xiang'jiang'dong'wu'yuan
猛涌	meng'yong
飘峰	piao'feng
万宝工业基地	wan'bao'gong'ye'ji'di
石壁路口	shi'bi'lu'kou
广州南站总站	guang'zhou'nan'zhan'zong'zhan
富石路	fu'shi'lu
石壁路口	shi'bi'lu'kou
谢村	xie'cun
锦绣文化中心	jin'xiu'wen'hua'zhong'xin
钟村市场	zhong'cun'shi'chang
锦绣生态园	jin'xiu'sheng'tai'yuan
大夫山北门	dai'fu'shan'bei'men
祈福医院	qi'fu'yi'yuan
祈福新邨总站	qi'fu'xin'cun'zong'zhan
海心沙公园	hai'xin'sha'gong'yuan
夏茅	xia'mao
站前路总站	zhan'qian'lu'zong'zhan
白马服装城	bai'ma'fu'zhuang'cheng
钟村	zhong'cun
敏捷集团	min'jie'ji'tuan
地铁市广路站	di'tie'shi'guang'lu'zhan
金山谷花园	jin'shan'gu'hua'yuan
小罗村	xiao'luo'cun
富豪山庄	fu'hao'shan'zhuang
左边村	zuo'bian'cun
丹山村	dan'shan'cun
丹山桥	dan'shan'qiao
百越广场东门	bai'yue'guang'chang'dong'men
市桥汽车站西门	shi'qiao'qi'che'zhan'xi'men
大北路	da'bei'lu
中医院分站	zhong'yi'yuan'fen'zhan
交通大厦分站	jiao'tong'da'sha'fen'zhan
邮电大厦	you'dian'da'sha
东秀园	dong'xiu'yuan
广场西路	guang'chang'xi'lu
东怡新区	dong'yi'xin'qu
清河市场	qing'he'shi'chang
石岗村	shi'gang'cun
金海岸花园	jin'hai'an'hua'yuan
番禺汽车客运站	pan'yu'qi'che'ke'yun'zhan
傍雁路临时公交总站	bang'yan'lu'lin'shi'gong'jiao'zong'zhan
番禺广场	pan'yu'guang'chang
星海公园	xing'hai'gong'yuan
雅居乐总站	ya'ju'le'zong'zhan
国际文化中心	guo'ji'wen'hua'zhong'xin
剑桥郡医院	jian'qiao'jun'yi'yuan
板桥东	ban'qiao'dong
南山公园	nan'shan'gong'yuan
南村医院	nan'cun'yi'yuan
南村综合市场	nan'cun'zong'he'shi'chang
南草塘	nan'cao'tang
岭南电缆厂	ling'nan'dian'lan'chang
利口福	li'kou'fu
陈边村	chen'bian'cun
地铁员岗站	di'tie'yuan'gang'zhan
员岗	yuan'gang
广州雅居乐	guang'zhou'ya'ju'le
官堂东	guan'tang'dong
官堂万达	guan'tang'wan'da
华南新城	hua'nan'xin'cheng
塘步东	tang'bu'dong
塘西	tang'xi
星河湾分站	xing'he'wan'fen'zhan
里仁洞	li'ren'dong
冼庄立交	xian'zhuang'li'jiao
万博翠湖花园	wan'bo'cui'hu'hua'yuan
龙美牌坊	long'mei'pai'fang
龙美村	long'mei'cun
番禺体育公园	pan'yu'ti'yu'gong'yuan
云星村	yun'xing'cun
黄编牌坊	huang'bian'pai'fang
市桥汽车站东门	shi'qiao'qi'che'zhan'dong'men
市桥汽车站	shi'qiao'qi'che'zhan
市桥街道办	shi'qiao'jie'dao'ban
节能科技园	jie'neng'ke'ji'yuan
南国奥林匹克花园	nan'guo'ao'lin'pi'ke'hua'yuan
地铁钟村站	di'tie'zhong'cun'zhan
锦绣香江分站	jin'xiu'xiang'jiang'fen'zhan
太古仓码头	tai'gu'cang'ma'tou
太古仓路总站	tai'gu'cang'lu'zong'zhan
革新路	ge'xin'lu
太古仓	tai'gu'cang
长隆旅游度假区总站	zhang'long'lyu'you'du'jia'qu'zong'zhan
南浦海滨花园	nan'pu'hai'bin'hua'yuan
广州碧桂园	guang'zhou'bi'gui'yuan
三山港中心小学	san'shan'gang'zhong'xin'xiao'xue
港口路中	gang'kou'lu'zhong
港口路南	gang'kou'lu'nan
环岛南路路口	huan'dao'nan'lu'lu'kou
礼村牌坊	li'cun'pai'fang
新月明珠花园	xin'yue'ming'zhu'hua'yuan
地铁大石站	di'tie'da'shi'zhan
河村	he'cun
植村	zhi'cun
礼村东	li'cun'dong
大石中心小学	da'shi'zhong'xin'xiao'xue
南浦三桥南	nan'pu'san'qiao'nan
南浦三桥北	nan'pu'san'qiao'bei
洛涛南区	luo'tao'nan'qu
东沙	dong'sha
石兴大道南	shi'xing'da'dao'nan
锦绣趣园	jin'xiu'qu'yuan
锦绣趣园东	jin'xiu'qu'yuan'dong
钟村小学	zhong'cun'xiao'xue
思蕴路总站	si'yun'lu'zong'zhan
天顺路	tian'shun'lu
神舟路南	shen'zhou'lu'nan
玉树新村	yu'shu'xin'cun
南云一路中	nan'yun'yi'lu'zhong
南云二路北	nan'yun'er'lu'bei
南云二路中	nan'yun'er'lu'zhong
南云二路南	nan'yun'er'lu'nan
科林路中	ke'lin'lu'zhong
南云五路	nan'yun'wu'lu
南云五路东	nan'yun'wu'lu'dong
科丰路北	ke'feng'lu'bei
科丰路中	ke'feng'lu'zhong
地铁文冲站	di'tie'wen'chong'zhan
石化生活区南	shi'hua'sheng'huo'qu'nan
大沙东总站	da'sha'dong'zong'zhan
航海学院正门	hang'hai'xue'yuan'zheng'men
玉树新村口	yu'shu'xin'cun'kou
开创大道立交	kai'chuang'da'dao'li'jiao
骏功路	jun'gong'lu
骏功路西	jun'gong'lu'xi
骏功路	jun'gong'lu
勒竹新村	lei'zhu'xin'cun
火村路口	huo'cun'lu'kou
小坑村	xiao'keng'cun
东捷路	dong'jie'lu
瑞和路北	rui'he'lu'bei
瑞和路北	rui'he'lu'bei
石桥新村	shi'qiao'xin'cun
开泰大道中	kai'tai'da'dao'zhong
开泰大道	kai'tai'da'dao
新乐路口	xin'le'lu'kou
新乐路	xin'le'lu
天丰路口	tian'feng'lu'kou
开泰大道	kai'tai'da'dao
沧头村总站	cang'tou'cun'zong'zhan
东兴市场	dong'xing'shi'chang
开发大道立交东	kai'fa'da'dao'li'jiao'dong
保利爱特城总站	bao'li'ai'te'cheng'zong'zhan
观达路中	guan'da'lu'zhong
云埔二路东	yun'bu'er'lu'dong
云埔二路	yun'bu'er'lu
云骏路	yun'jun'lu
天生路	tian'sheng'lu
双井村口	shuang'jing'cun'kou
东达路	dong'da'lu
东达路	dong'da'lu
埔南路东	bu'nan'lu'dong
埔南路中	bu'nan'lu'zhong
埔南路	bu'nan'lu
翠山路	cui'shan'lu
开达路南	kai'da'lu'nan
开达路中	kai'da'lu'zhong
开达路北	kai'da'lu'bei
地铁萝岗站	di'tie'luo'gang'zhan
开创大道	kai'chuang'da'dao
开创大道	kai'chuang'da'dao
地铁苏元站	di'tie'su'yuan'zhan
地铁暹岗站	di'tie'xian'gang'zhan
暹岗村西	xian'gang'cun'xi
开创大道	kai'chuang'da'dao
地铁金峰站	di'tie'jin'feng'zhan
开创大道	kai'chuang'da'dao
联和路口	lian'he'lu'kou
天鹿小区	tian'lu'xiao'qu
华扬路	hua'yang'lu
联和总站	lian'he'zong'zhan
岭南学院	ling'nan'xue'yuan
科学大道	ke'xue'da'dao
科学大道西	ke'xue'da'dao'xi
崖鹰石路	ya'ying'shi'lu
崖鹰石路北	ya'ying'shi'lu'bei
长安村口	chang'an'cun'kou
香山路	xiang'shan'lu
金峰园路	jin'feng'yuan'lu
光谱中路	guang'pu'zhong'lu
广州科技创新基地	guang'zhou'ke'ji'chuang'xin'ji'di
揽月路	lan'yue'lu
天丰路	tian'feng'lu
光谱中路东	guang'pu'zhong'lu'dong
长岭路总站	chang'ling'lu'zong'zhan
长岭路	chang'ling'lu
贤江西	xian'jiang'xi
贤江公园	xian'jiang'gong'yuan
贤江	xian'jiang
江东村	jiang'dong'cun
新丰路口	xin'feng'lu'kou
植树公园	zhi'shu'gong'yuan
生物研究院	sheng'wu'yan'jiu'yuan
开源大道中	kai'yuan'da'dao'zhong
黄埔区图书馆	huang'pu'qu'tu'shu'guan
香雪公寓	xiang'xue'gong'yu
香雪八路南	xiang'xue'ba'lu'nan
香雪八路中	xiang'xue'ba'lu'zhong
元贝	yuan'bei
峻祥路	jun'xiang'lu
科城山庄总站	ke'cheng'shan'zhuang'zong'zhan
岭头东	ling'tou'dong
市干部健康管理中心	shi'gan'bu'jian'kang'guan'li'zhong'xin
岭头	ling'tou
茅坦村	mao'tan'cun
长岭居小学	chang'ling'ju'xiao'xue
羌洞	qiang'dong
萝岭路	luo'ling'lu
黄埔区萝岗福利院	huang'pu'qu'luo'gang'fu'li'yuan
长贤路	zhang'xian'lu
水元东路	shui'yuan'dong'lu
元贝桥	yuan'bei'qiao
开萝大道	kai'luo'da'dao
开萝大道	kai'luo'da'dao
黄埔图书馆北	huang'pu'tu'shu'guan'bei
香雪大道	xiang'xue'da'dao
猛田村	meng'tian'cun
萝峰村	luo'feng'cun
坑围村	keng'wei'cun
萝岗	luo'gang
萝岗香雪总站	luo'gang'xiang'xue'zong'zhan
丰乐南路总站	feng'le'nan'lu'zong'zhan
怡港花园	yi'gang'hua'yuan
茅岗路南	mao'gang'lu'nan
坑田	keng'tian
坑头	keng'tou
地铁长平站	di'tie'chang'ping'zhan
地铁长平站	di'tie'chang'ping'zhan
新丰路	xin'feng'lu
新丰路中	xin'feng'lu'zhong
红旗路	hong'qi'lu
实地常春藤总站	shi'di'chang'chun'teng'zong'zhan
水西村委	shui'xi'cun'wei
水西村	shui'xi'cun
孖塘	ma'tang
屋角	wu'jiao
甘竹村口	gan'zhu'cun'kou
布岭路	bu'ling'lu
布岭路	bu'ling'lu
永和总站	yong'he'zong'zhan
永顺大道	yong'shun'da'dao
水南村总站	shui'nan'cun'zong'zhan
新墩大道	xin'dun'da'dao
新墩下基市场大街	xin'dun'xia'ji'shi'chang'da'jie
新墩村口	xin'dun'cun'kou
沧联总站	cang'lian'zong'zhan
长江路总站	chang'jiang'lu'zong'zhan
金州新邨	jin'zhou'xin'cun
长江路口	chang'jiang'lu'kou
深井文塔公园	shen'jing'wen'ta'gong'yuan
南田坊	nan'tian'fang
华工北路	hua'gong'bei'lu
华工北路东	hua'gong'bei'lu'dong
大学城客运中心总站	da'xue'cheng'ke'yun'zhong'xin'zong'zhan
联和墟	lian'he'xu
田心村	tian'xin'cun
联和北	lian'he'bei
天鹿湖郊野公园	tian'lu'hu'jiao'ye'gong'yuan
天鹿湖隧道北	tian'lu'hu'sui'dao'bei
康平路	kang'ping'lu
北社路中	bei'she'lu'zhong
北社路	bei'she'lu
天鹿湖老年人护理中心总站	tian'lu'hu'lao'nian'ren'hu'li'zhong'xin'zong'zhan
猛田村	meng'tian'cun
香雪大道图书馆北门	xiang'xue'da'dao'tu'shu'guan'bei'men
黄埔区青少年宫	huang'pu'qu'qing'shao'nian'gong
萝岗中心区公交站场	luo'gang'zhong'xin'qu'gong'jiao'zhan'chang
演艺中心北门	yan'yi'zhong'xin'bei'men
萝岗市民广场	luo'gang'shi'min'guang'chang
香雪二路	xiang'xue'er'lu
科学大道	ke'xue'da'dao
科学广场	ke'xue'guang'chang
地铁科学城站	di'tie'ke'xue'cheng'zhan
开泰大道	kai'tai'da'dao
科翔路	ke'xiang'lu
大观北路	da'guan'bei'lu
大观路北总站	da'guan'lu'bei'zong'zhan
力康路	li'kang'lu
萝岗万达广场总站	luo'gang'wan'da'guang'chang'zong'zhan
新阳西路口	xin'yang'xi'lu'kou
广州区块链国际创新中心	guang'zhou'qu'kuai'lian'guo'ji'chuang'xin'zhong'xin
伴河路	ban'he'lu
伴河路南	ban'he'lu'nan
果园一路	guo'yuan'yi'lu
骏达路中	jun'da'lu'zhong
东鹏大道	dong'peng'da'dao
骏业路中	jun'ye'lu'zhong
骏业路东	jun'ye'lu'dong
宏光路中	hong'guang'lu'zhong
出口加工区	chu'kou'jia'gong'qu
宏明路口	hong'ming'lu'kou
东区中学	dong'qu'zhong'xue
南岗总站	nan'gang'zong'zhan
科学城彩频路总站	ke'xue'cheng'cai'pin'lu'zong'zhan
光谱中路	guang'pu'zhong'lu
光谱东路	guang'pu'dong'lu
萝坎村	luo'kan'cun
华甫村	hua'fu'cun
萝格路口	luo'ge'lu'kou
云埔工业区口	yun'bu'gong'ye'qu'kou
岗贝村	gang'bei'cun
云骏路中	yun'jun'lu'zhong
云埔一路总站	yun'bu'yi'lu'zong'zhan
新桂路	xin'gui'lu
新桂路南	xin'gui'lu'nan
大观路	da'guan'lu
科翔路	ke'xiang'lu
科翔路	ke'xiang'lu
发源路中	fa'yuan'lu'zhong
发源路	fa'yuan'lu
中海公寓	zhong'hai'gong'yu
洋城一路	yang'cheng'yi'lu
中海誉城总站	zhong'hai'yu'cheng'zong'zhan
萝峰村口	luo'feng'cun'kou
萝峰小学	luo'feng'xiao'xue
荔红路	li'hong'lu
荔红中路	li'hong'zhong'lu
瑞和路	rui'he'lu
瑞和路南	rui'he'lu'nan
火村东	huo'cun'dong
东明二路	dong'ming'er'lu
赵溪路口	zhao'xi'lu'kou
勒竹旧村	lei'zhu'jiu'cun
乌石村北	wu'shi'cun'bei
东鹏大道	dong'peng'da'dao
笔村总站	bi'cun'zong'zhan
笔岗村	bi'gang'cun
茅岗口	mao'gang'kou
茅岗村	mao'gang'cun
护林路	hu'lin'lu
护林路中	hu'lin'lu'zhong
护林路	hu'lin'lu
启学路	qi'xue'lu
启学路	qi'xue'lu
笔村总站	bi'cun'zong'zhan
圣堂街北	sheng'tang'jie'bei
笔岗村口	bi'gang'cun'kou
宏明路中	hong'ming'lu'zhong
沧联市场	cang'lian'shi'chang
沧联社区	cang'lian'she'qu
沧联小学	cang'lian'xiao'xue
沧联二路	cang'lian'er'lu
沧头桥	cang'tou'qiao
东达路南	dong'da'lu'nan
诚联公园	cheng'lian'gong'yuan
埔北路	bu'bei'lu
春分路总站	chun'fen'lu'zong'zhan
斗塘路东	dou'tang'lu'dong
香荔路北	xiang'li'lu'bei
香荔路	xiang'li'lu
香荔二路	xiang'li'er'lu
树吓村	shu'xia'cun
新庄村委	xin'zhuang'cun'wei
甘竹村	gan'zhu'cun
来安四街	lai'an'si'jie
来安三街	lai'an'san'jie
永丰路	yong'feng'lu
华峰寺总站	hua'feng'si'zong'zhan
华峰路口	hua'feng'lu'kou
华峰路	hua'feng'lu
莲塘村	lian'tang'cun
九太路	jiu'tai'lu
燕塘村	yan'tang'cun
岗埔街	gang'bu'jie
重岗村	zhong'gang'cun
新村一巷	xin'cun'yi'xiang
驳塘街	bo'tang'jie
山龙村委	shan'long'cun'wei
九佛二中北门	jiu'fu'er'zhong'bei'men
九龙镇新市场	jiu'long'zhen'xin'shi'chang
荷棠下村	he'tang'xia'cun
九龙镇政府	jiu'long'zhen'zheng'fu
长庚村总站	chang'geng'cun'zong'zhan
知识城南	zhi'shi'cheng'nan
创新大道	chuang'xin'da'dao
会元学校	hui'yuan'xue'xiao
凤湖四路	feng'hu'si'lu
棠下村口	tang'xia'cun'kou
长棠路口	zhang'tang'lu'kou
埔心村口	bu'xin'cun'kou
地铁知识城站	di'tie'zhi'shi'cheng'zhan
九龙镇政府	jiu'long'zhen'zheng'fu
九太路口	jiu'tai'lu'kou
七星庄	qi'xing'zhuang
地铁枫下站	di'tie'feng'xia'zhan
枫下村	feng'xia'cun
枫下村北	feng'xia'cun'bei
蟹庄村口	xie'zhuang'cun'kou
新南村	xin'nan'cun
九龙大道	jiu'long'da'dao
富田岗	fu'tian'gang
凤凰二路西	feng'huang'er'lu'xi
凤凰二路中	feng'huang'er'lu'zhong
凤凰一横路北	feng'huang'yi'heng'lu'bei
凤凰一横路	feng'huang'yi'heng'lu
凤凰四路东	feng'huang'si'lu'dong
凤凰三横路南	feng'huang'san'heng'lu'nan
知识城北安置区	zhi'shi'cheng'bei'an'zhi'qu
凤凰一横路南	feng'huang'yi'heng'lu'nan
知识城南	zhi'shi'cheng'nan
狮龙大道北	shi'long'da'dao'bei
棠上路总站	tang'shang'lu'zong'zhan
棠上路口	tang'shang'lu'kou
粤芯路	yue'xin'lu
凤凰五路中	feng'huang'wu'lu'zhong
知识城政务中心	zhi'shi'cheng'zheng'wu'zhong'xin
佛公路	fu'gong'lu
凤尾村委	feng'wei'cun'wei
凤尾路	feng'wei'lu
凤尾村	feng'wei'cun
凤尾村总站	feng'wei'cun'zong'zhan
地铁红卫站	di'tie'hong'wei'zhan
玉树新村总站	yu'shu'xin'cun'zong'zhan
玉树新村路口	yu'shu'xin'cun'lu'kou
南翔二路	nan'xiang'er'lu
南翔二路中	nan'xiang'er'lu'zhong
南翔二路东	nan'xiang'er'lu'dong
南云四路	nan'yun'si'lu
南翔三路	nan'xiang'san'lu
南云三路南	nan'yun'san'lu'nan
南云五路口	nan'yun'wu'lu'kou
班岭村口	ban'ling'cun'kou
黄麻村	huang'ma'cun
长龙村西	chang'long'cun'xi
长龙村	chang'long'cun
永顺大道总站	yong'shun'da'dao'zong'zhan
地铁何棠下站	di'tie'he'tang'xia'zhan
地铁旺村站	di'tie'wang'cun'zhan
坳岗	ao'gang
业田村	ye'tian'cun
地铁汤村站	di'tie'tang'cun'zhan
广州商学院	guang'zhou'shang'xue'yuan
石沥村口	shi'li'cun'kou
五福堂	wu'fu'tang
地铁镇龙北站	di'tie'zhen'long'bei'zhan
向西村口	xiang'xi'cun'kou
镇龙墟	zhen'long'xu
地铁镇龙西站	di'tie'zhen'long'xi'zhan
镇龙医院	zhen'long'yi'yuan
镇龙一中	zhen'long'yi'zhong
福洞村路口	fu'dong'cun'lu'kou
均和村	jun'he'cun
旗冚村	qi'kan'cun
朱屋	zhu'wu
邓家	deng'jia
金坑	jin'keng
澳洲山庄	ao'zhou'shan'zhuang
李伯坳	li'bo'ao
芳二社	fang'er'she
黄登村口	huang'deng'cun'kou
芳一社	fang'yi'she
木摾水库	mu'jiang'shui'ku
长平村	chang'ping'cun
地铁金坑站	di'tie'jin'keng'zhan
长福路总站	zhang'fu'lu'zong'zhan
长福路口	zhang'fu'lu'kou
天鹿湖森林公园北门	tian'lu'hu'sen'lin'gong'yuan'bei'men
慕园村	mu'yuan'cun
八斗立交北	ba'dou'li'jiao'bei
天鹿北路	tian'lu'bei'lu
八斗村	ba'dou'cun
茶山下	cha'shan'xia
兴太三路	xing'tai'san'lu
梅田村路口	mei'tian'cun'lu'kou
穗丰村	sui'feng'cun
穗丰村总站	sui'feng'cun'zong'zhan
天鹿北路中	tian'lu'bei'lu'zhong
笔村立交北	bi'cun'li'jiao'bei
乌石村	wu'shi'cun
捷普电子厂	jie'pu'dian'zi'chang
赵溪村	zhao'xi'cun
骏业路西	jun'ye'lu'xi
云埔一路	yun'bu'yi'lu
观达路北	guan'da'lu'bei
中海誉城南门	zhong'hai'yu'cheng'nan'men
灵山东路西	ling'shan'dong'lu'xi
塘口	tang'kou
地铁鱼珠站	di'tie'yu'zhu'zhan
鱼茅路	yu'mao'lu
海员路	hai'yuan'lu
灵山东路	ling'shan'dong'lu
开泰大道	kai'tai'da'dao
庄埔路口	zhuang'bu'lu'kou
庄埔路中	zhuang'bu'lu'zhong
上埔庄路口	shang'bu'zhuang'lu'kou
埔心村	bu'xin'cun
棠埔东路	tang'bu'dong'lu
斯迳路	si'jing'lu
斯迳路	si'jing'lu
虎窿村总站	hu'long'cun'zong'zhan
凤凰下街	feng'huang'xia'jie
建设新街	jian'she'xin'jie
下南路口	xia'nan'lu'kou
佛塱路口	fu'lang'lu'kou
佛塱村委	fu'lang'cun'wei
狮地村	shi'di'cun
秋风路口	qiu'feng'lu'kou
上中坑村	shang'zhong'keng'cun
下佰坑村	xia'bai'keng'cun
九腌地路口	jiu'yan'di'lu'kou
佛塱村	fu'lang'cun
知识城南总站	zhi'shi'cheng'nan'zong'zhan
凤凰湖	feng'huang'hu
凤湖中路	feng'hu'zhong'lu
凤湖二路东	feng'hu'er'lu'dong
凤湖中路	feng'hu'zhong'lu
凤湖一路	feng'hu'yi'lu
开发区技工学校	kai'fa'qu'ji'gong'xue'xiao
旺村文体广场	wang'cun'wen'ti'guang'chang
旺村东	wang'cun'dong
旺村北	wang'cun'bei
山边	shan'bian
丫塘路	ya'tang'lu
美荔公园	mei'li'gong'yuan
佛子庄	fo'zi'zhuang
洋田塘口	yang'tian'tang'kou
窖吓村	jiao'xia'cun
洋田村总站	yang'tian'cun'zong'zhan
棠下路口	tang'xia'lu'kou
金水里村口	jin'shui'li'cun'kou
金水里西	jin'shui'li'xi
金水里东	jin'shui'li'dong
竹山村	zhu'shan'cun
迳下村	jing'xia'cun
迳下村总站	jing'xia'cun'zong'zhan
地铁官洲站总站	di'tie'guan'zhou'zhan'zong'zhan
螺旋大道西	luo'xuan'da'dao'xi
星岛环北路	xing'dao'huan'bei'lu
螺旋四路西	luo'xuan'si'lu'xi
螺旋四路东	luo'xuan'si'lu'dong
星岛环南路	xing'dao'huan'nan'lu
星汉大道	xing'han'da'dao
星汉大道北	xing'han'da'dao'bei
生物岛叠翠园	sheng'wu'dao'die'cui'yuan
星岛环南路北	xing'dao'huan'nan'lu'bei
生物岛水墨园	sheng'wu'dao'shui'mo'yuan
水均田路北	shui'jun'tian'lu'bei
水均田路中	shui'jun'tian'lu'zhong
水均田路	shui'jun'tian'lu
水均田村	shui'jun'tian'cun
黄登村北	huang'deng'cun'bei
黄登村	huang'deng'cun
茅岗新村	mao'gang'xin'cun
地铁大沙地站	di'tie'da'sha'di'zhan
市八十六中	shi'ba'shi'liu'zhong
大沙地西	da'sha'di'xi
地铁大沙地站	di'tie'da'sha'di'zhan
护林路东	hu'lin'lu'dong
石化南一街	shi'hua'nan'yi'jie
石化小学	shi'hua'xiao'xue
瑞东花园南门	rui'dong'hua'yuan'nan'men
瑞东花园总站	rui'dong'hua'yuan'zong'zhan
护林路	hu'lin'lu
湖山国际公交总站	hu'shan'guo'ji'gong'jiao'zong'zhan
陈家林路	chen'jia'lin'lu
埔南路	bu'nan'lu
翡翠绿洲南门	fei'cui'lyu'zhou'nan'men
瑞祥路	rui'xiang'lu
笔岗新村总站	bi'gang'xin'cun'zong'zhan
开拓路口	kai'tuo'lu'kou
华坑生态村	hua'keng'sheng'tai'cun
华坑路	hua'keng'lu
大沙东延长线	da'sha'dong'yan'chang'xian
地铁文冲站	di'tie'wen'chong'zhan
内环西路	nei'huan'xi'lu
广大附小	guang'da'fu'xiao
中大	zhong'da
中环东路	zhong'huan'dong'lu
广外正门	guang'wai'zheng'men
三角亭	san'jiao'ting
黄船二街口	huang'chuan'er'jie'kou
黄船集体宿舍	huang'chuan'ji'ti'su'she
黄船文化中心	huang'chuan'wen'hua'zhong'xin
坪岗	ping'gang
思亭路总站	si'ting'lu'zong'zhan
档案馆路	dang'an'guan'lu
国医东路	guo'yi'dong'lu
黄船文化中心	huang'chuan'wen'hua'zhong'xin
上罗村总站	shang'luo'cun'zong'zhan
佛塱山贝	fu'lang'shan'bei
埔心路口	bu'xin'lu'kou
芒林街	mang'lin'jie
大埔路	da'bu'lu
下南路	xia'nan'lu
友谊路口	you'yi'lu'kou
志诚大道东	zhi'cheng'da'dao'dong
东江大道中	dong'jiang'da'dao'zhong
员工大厦	yuan'gong'da'sha
东江大道南	dong'jiang'da'dao'nan
金碧路	jin'bi'lu
明珠路	ming'zhu'lu
明珠路南	ming'zhu'lu'nan
明珠路中	ming'zhu'lu'zhong
志诚大道西	zhi'cheng'da'dao'xi
大观路北	da'guan'lu'bei
科珠路南	ke'zhu'lu'nan
大淋岗村	da'lin'gang'cun
吉山坑尾路口	ji'shan'keng'wei'lu'kou
吉山坑尾路	ji'shan'keng'wei'lu
吉山新路街	ji'shan'xin'lu'jie
岐山路口	qi'shan'lu'kou
茅岗市场	mao'gang'shi'chang
地铁香雪站总站	di'tie'xiang'xue'zhan'zong'zhan
玉岩路南	yu'yan'lu'nan
永和大道	yong'he'da'dao
地铁镇龙站总站	di'tie'zhen'long'zhan'zong'zhan
田园路	tian'yuan'lu
新安路北	xin'an'lu'bei
新安路	xin'an'lu
斗塘路西	dou'tang'lu'xi
禾丰路中	he'feng'lu'zhong
禾丰村	he'feng'cun
永龙大道南	yong'long'da'dao'nan
永龙大道	yong'long'da'dao
永龙大道中	yong'long'da'dao'zhong
兴龙大道	xing'long'da'dao
兴龙大道	xing'long'da'dao
九龙大道南	jiu'long'da'dao'nan
鱼珠码头	yu'zhu'ma'tou
萝岗会议中心	luo'gang'hui'yi'zhong'xin
萝岗会议中心西	luo'gang'hui'yi'zhong'xin'xi
创业公园	chuang'ye'gong'yuan
地铁水西站	di'tie'shui'xi'zhan
水西路北	shui'xi'lu'bei
水西路总站	shui'xi'lu'zong'zhan
科丰路	ke'feng'lu
火村东	huo'cun'dong
瑞发路南	rui'fa'lu'nan
瑞发路中	rui'fa'lu'zhong
玉岩路中	yu'yan'lu'zhong
南湾	nan'wan
大盛村	da'sheng'cun
东盛	dong'sheng
玖龙宿舍1站	jiu'long'su'she'1'zhan
新洛围	xin'luo'wei
马滘河	ma'jiao'he
华阳湖路口	hua'yang'hu'lu'kou
麻三村	ma'san'cun
麻涌汽车站	ma'yong'qi'che'zhan
麻涌市场	ma'yong'shi'chang
江畔湾北门	jiang'pan'wan'bei'men
麻涌一中	ma'yong'yi'zhong
中大新华学院总站	zhong'da'xin'hua'xue'yuan'zong'zhan
麻涌市场	ma'yong'shi'chang
信华路	xin'hua'lu
信华路口	xin'hua'lu'kou
麻一工业区	ma'yi'gong'ye'qu
狮龙大道北总站	shi'long'da'dao'bei'zong'zhan
康大路口	kang'da'lu'kou
恒大山水城	heng'da'shan'shui'cheng
中福路	zhong'fu'lu
中新墟	zhong'xin'xu
景新国际	jing'xin'guo'ji
坑贝地铁站	keng'bei'di'tie'zhan
坑贝村	keng'bei'cun
莲塘村	lian'tang'cun
燕岗桥	yan'gang'qiao
凤岗地铁站	feng'gang'di'tie'zhan
江山时代	jiang'shan'shi'dai
朱村医院	zhu'cun'yi'yuan
朱村客运站总站	zhu'cun'ke'yun'zhan'zong'zhan
演艺中心南门	yan'yi'zhong'xin'nan'men
萝岗大塱村	luo'gang'da'lang'cun
开创大道	kai'chuang'da'dao
地铁香雪站	di'tie'xiang'xue'zhan
新庄二路	xin'zhuang'er'lu
永和综合楼	yong'he'zong'he'lou
横迳广场	heng'jing'guang'chang
井泉一路	jing'quan'yi'lu
井泉四路	jing'quan'si'lu
永顺大道	yong'shun'da'dao
顺龙厂	shun'long'chang
永和加油站	yong'he'jia'you'zhan
永和中学	yong'he'zhong'xue
钧明欢乐世界	jun'ming'huan'le'shi'jie
东凌工业园	dong'ling'gong'ye'yuan
塔岗村	ta'gang'cun
翟洞村	di'dong'cun
公安村	gong'an'cun
荔湖城	li'hu'cheng
合景誉山国际公交场总站	he'jing'yu'shan'guo'ji'gong'jiao'chang'zong'zhan
南安村	nan'an'cun
暨华医院	ji'hua'yi'yuan
凤盈苑西门	feng'ying'yuan'xi'men
凤盈苑南门	feng'ying'yuan'nan'men
合生湖山国际峰景	he'sheng'hu'shan'guo'ji'feng'jing
凤荔苑	feng'li'yuan
凤凰城大道	feng'huang'cheng'da'dao
凤凰苑南门	feng'huang'yuan'nan'men
凤凰城	feng'huang'cheng
东方名都	dong'fang'ming'dou
白江地铁站	bai'jiang'di'tie'zhan
新塘盛世名门总站	xin'tang'sheng'shi'ming'men'zong'zhan
凤馨苑	feng'xin'yuan
翡翠绿洲	fei'cui'lyu'zhou
萝岗总站	luo'gang'zong'zhan
田园路中	tian'yuan'lu'zhong
桑田三路南	sang'tian'san'lu'nan
永顺大道东	yong'shun'da'dao'dong
海伦春天	hai'lun'chun'tian
崇和花园	chong'he'hua'yuan
奥园誉峰	ao'yuan'yu'feng
誉山国际五区	yu'shan'guo'ji'wu'qu
钟陂头村	zhong'bei'tou'cun
保利i立方	bao'li'i'li'fang
誉山国际北门	yu'shan'guo'ji'bei'men
凤凰城凤馨苑总站	feng'huang'cheng'feng'xin'yuan'zong'zhan
丹水坑路中	dan'shui'keng'lu'zhong
丹水坑路南	dan'shui'keng'lu'nan
中南路北	zhong'nan'lu'bei
富力悦禧花园总站	fu'li'yue'xi'hua'yuan'zong'zhan
广州亿仁医院	guang'zhou'yi'ren'yi'yuan
石化路口	shi'hua'lu'kou
开发区管委会	kai'fa'qu'guan'wei'hui
玖龙宿舍	jiu'long'su'she
麻涌市场	ma'yong'shi'chang
麻涌镇政府	ma'yong'zhen'zheng'fu
大步村	da'bu'cun
大步公园	da'bu'gong'yuan
椰林山庄	ye'lin'shan'zhuang
中心大道	zhong'xin'da'dao
大步泥鱼坦	da'bu'ni'yu'tan
铜雀台	tong'que'tai
珠江东岸	zhu'jiang'dong'an
碧桂园十里江湾总站	bi'gui'yuan'shi'li'jiang'wan'zong'zhan
新塘总站	xin'tang'zong'zhan
锦绣新天地	jin'xiu'xin'tian'di
新聚福	xin'ju'fu
太阳城	tai'yang'cheng
四环岛	si'huan'dao
凤凰城五环岛	feng'huang'cheng'wu'huan'dao
岗丰大道	gang'feng'da'dao
广惠高速路口	guang'hui'gao'su'lu'kou
新业路	xin'ye'lu
禾丰路	he'feng'lu
永和总站	yong'he'zong'zhan
广东药学院	guang'dong'yao'xue'yuan
穗石村	sui'shi'cun
华工正门	hua'gong'zheng'men
岭南印象园	ling'nan'yin'xiang'yuan
广工正门	guang'gong'zheng'men
外环西路	wai'huan'xi'lu
华师正门	hua'shi'zheng'men
中心北大街	zhong'xin'bei'da'jie
外环东路	wai'huan'dong'lu
中大正门	zhong'da'zheng'men
广外西路路口	guang'wai'xi'lu'lu'kou
广中医正门	guang'zhong'yi'zheng'men
广药路路口	guang'yao'lu'lu'kou
内环东路	nei'huan'dong'lu
广药生活区	guang'yao'sheng'huo'qu
广中医路	guang'zhong'yi'lu
广中医路路口	guang'zhong'yi'lu'lu'kou
长洲街办	chang'zhou'jie'ban
上庄村	shang'zhuang'cun
黄埔军校纪念中学	huang'pu'jun'xiao'ji'nian'zhong'xue
长洲岛小学	chang'zhou'dao'xiao'xue
福南坊	fu'nan'fang
金洲北路	jin'zhou'bei'lu
长洲路口	chang'zhou'lu'kou
长洲码头总站	chang'zhou'ma'tou'zong'zhan
大学城南亭村总站	da'xue'cheng'nan'ting'cun'zong'zhan
广工一路南	guang'gong'yi'lu'nan
广工一路	guang'gong'yi'lu
地铁大学城南站	di'tie'da'xue'cheng'nan'zhan
南亭村口	nan'ting'cun'kou
华师附属大学城小学	hua'shi'fu'shu'da'xue'cheng'xiao'xue
大学城穗石村总站	da'xue'cheng'sui'shi'cun'zong'zhan
笔岗路	bi'gang'lu
揽月路西	lan'yue'lu'xi
科学城南部公交场总站	ke'xue'cheng'nan'bu'gong'jiao'chang'zong'zhan
华坑生态村	hua'keng'sheng'tai'cun
护林路西	hu'lin'lu'xi
天河儿童公园	tian'he'er'tong'gong'yuan
科珠路口	ke'zhu'lu'kou
吉山小学	ji'shan'xiao'xue
开达路北	kai'da'lu'bei
中华永久墓园	zhong'hua'yong'jiu'mu'yuan
开发区电大	kai'fa'qu'dian'da
萝岭路南	luo'ling'lu'nan
长贤路东	zhang'xian'lu'dong
长贤路	zhang'xian'lu
登穗路口	deng'sui'lu'kou
杉山巷路口	shan'shan'xiang'lu'kou
黄登村	huang'deng'cun
开泰大道	kai'tai'da'dao
永和贤江公交总站	yong'he'xian'jiang'gong'jiao'zong'zhan
九岭路	jiu'ling'lu
禾丰新村西门	he'feng'xin'cun'xi'men
禾丰环路南	he'feng'huan'lu'nan
禾丰新村东门	he'feng'xin'cun'dong'men
永和医院路口	yong'he'yi'yuan'lu'kou
新新大道中	xin'xin'da'dao'zhong
永和汽车站	yong'he'qi'che'zhan
南翔一路中	nan'xiang'yi'lu'zhong
南翔一路东	nan'xiang'yi'lu'dong
映日路中	ying'ri'lu'zhong
映日路东	ying'ri'lu'dong
东鹏大道中	dong'peng'da'dao'zhong
三保工业区	san'bao'gong'ye'qu
丹水坑路口	dan'shui'keng'lu'kou
丹水坑风景区总站	dan'shui'keng'feng'jing'qu'zong'zhan
长福路中	zhang'fu'lu'zhong
能源路	neng'yuan'lu
东莞庄路	dong'guan'zhuang'lu
东莞庄路中	dong'guan'zhuang'lu'zhong
东莞庄路南	dong'guan'zhuang'lu'nan
员村同乐花园总站	yuan'cun'tong'le'hua'yuan'zong'zhan
员村南街	yuan'cun'nan'jie
二棉厂	er'mian'chang
康湖大街	kang'hu'da'jie
员村家乐福	yuan'cun'jia'le'fu
东璟街	dong'jing'jie
员村西街	yuan'cun'xi'jie
桃园西路北	tao'yuan'xi'lu'bei
桃园中路	tao'yuan'zhong'lu
杨桃公园	yang'tao'gong'yuan
地铁三溪站	di'tie'san'xi'zhan
家和天曜总站	jia'he'tian'yao'zong'zhan
悦景路东	yue'jing'lu'dong
悦景路中	yue'jing'lu'zhong
地铁东圃站总站	di'tie'dong'pu'zhan'zong'zhan
东圃二马路	dong'pu'er'ma'lu
东圃大马路	dong'pu'da'ma'lu
东圃大马路北	dong'pu'da'ma'lu'bei
黄村路	huang'cun'lu
黄村路	huang'cun'lu
育英路	yu'ying'lu
黄村北路	huang'cun'bei'lu
黄村北总站	huang'cun'bei'zong'zhan
乐天创意园总站	le'tian'chuang'yi'yuan'zong'zhan
五山路	wu'shan'lu
穗园小区	sui'yuan'xiao'qu
龙口东路北	long'kou'dong'lu'bei
龙口东路南	long'kou'dong'lu'nan
岗顶	gang'ding
龙口西路南	long'kou'xi'lu'nan
龙口西路中	long'kou'xi'lu'zhong
珠江新城总站	zhu'jiang'xin'cheng'zong'zhan
花城大道	hua'cheng'da'dao
海安路	hai'an'lu
石牌村牌坊	shi'pai'cun'pai'fang
海安路西	hai'an'lu'xi
市政务服务中心	shi'zheng'wu'fu'wu'zhong'xin
广州大剧院西门	guang'zhou'da'ju'yuan'xi'men
科新路	ke'xin'lu
科新路口	ke'xin'lu'kou
鳌鱼岗总站	ao'yu'gang'zong'zhan
地铁菊树站	di'tie'ju'shu'zhan
水口坊	shui'kou'fang
棉村	mian'cun
棉村市场	mian'cun'shi'chang
香凝学校	xiang'ning'xue'xiao
海南南丫西	hai'nan'nan'ya'xi
海南南丫东	hai'nan'nan'ya'dong
生南	sheng'nan
海南生北坊	hai'nan'sheng'bei'fang
海南连生坊	hai'nan'lian'sheng'fang
海南南丫村口	hai'nan'nan'ya'cun'kou
中海锦城总站	zhong'hai'jin'cheng'zong'zhan
汇泉路东	hui'quan'lu'dong
汇泉路	hui'quan'lu
融通路中	rong'tong'lu'zhong
万科金域中央北	wan'ke'jin'yu'zhong'yang'bei
五丫口大桥东	wu'ya'kou'da'qiao'dong
地铁龙溪站	di'tie'long'xi'zhan
龙溪大道西	long'xi'da'dao'xi
增滘立交西	zeng'jiao'li'jiao'xi
芳村体育中心	fang'cun'ti'yu'zhong'xin
龙溪大道中	long'xi'da'dao'zhong
中海锦城南	zhong'hai'jin'cheng'nan
南岸路	nan'an'lu
周门路	zhou'men'lu
彩虹社区	cai'hong'she'qu
荔湾图书馆	li'wan'tu'shu'guan
周门	zhou'men
芳村葵蓬总站	fang'cun'kui'peng'zong'zhan
葵蓬小学	kui'peng'xiao'xue
葵蓬村委	kui'peng'cun'wei
葵蓬一队	kui'peng'yi'dui
洞企石路	dong'qi'shi'lu
茶叶市场	cha'ye'shi'chang
芳村合兴苑	fang'cun'he'xing'yuan
南岸路口	nan'an'lu'kou
南源街	nan'yuan'jie
隔塘大街	ge'tang'da'jie
河柳街	he'liu'jie
坦尾总站	tan'wei'zong'zhan
桥中南路	qiao'zhong'nan'lu
柏悦湾	bo'yue'wan
桥中北路	qiao'zhong'bei'lu
河沙中路	he'sha'zhong'lu
东海北路口	dong'hai'bei'lu'kou
东海北路中	dong'hai'bei'lu'zhong
广东商贸职业学校	guang'dong'shang'mao'zhi'ye'xue'xiao
珠岛花园公交场	zhu'dao'hua'yuan'gong'jiao'chang
沙洛工业园	sha'luo'gong'ye'yuan
沙洛市场	sha'luo'shi'chang
沙洛村委	sha'luo'cun'wei
沙洛村	sha'luo'cun
东塱市场	dong'lang'shi'chang
向阳村	xiang'yang'cun
洞庭路	dong'ting'lu
河东路口	he'dong'lu'kou
雅居乐·雍景豪园	ya'ju'le'yong'jing'hao'yuan
迎海国际茶都	ying'hai'guo'ji'cha'dou
穗盐路	sui'yan'lu
润云路南	run'yun'lu'nan
润云路中	run'yun'lu'zhong
风正街	feng'zheng'jie
天云街	tian'yun'jie
润云路	run'yun'lu
谊信路口	yi'xin'lu'kou
南航新村总站	nan'hang'xin'cun'zong'zhan
西苑南街	xi'yuan'nan'jie
棠乐路	tang'le'lu
棠乐路口	tang'le'lu'kou
棠涌村委	tang'yong'cun'wei
直巷	zhi'xiang
新市新街西	xin'shi'xin'jie'xi
新市新街中	xin'shi'xin'jie'zhong
新市新街口	xin'shi'xin'jie'kou
萧岗市场	xiao'gang'shi'chang
新市南街	xin'shi'nan'jie
涌北大街口	yong'bei'da'jie'kou
萧岗涌北大街	xiao'gang'yong'bei'da'jie
花园路	hua'yuan'lu
花园路口	hua'yuan'lu'kou
白云文化广场总站	bai'yun'wen'hua'guang'chang'zong'zhan
大冈村总站	da'gang'cun'zong'zhan
大冈街	da'gang'jie
大冈小学	da'gang'xiao'xue
大冈村口	da'gang'cun'kou
金宝路	jin'bao'lu
大冈兰花街	da'gang'lan'hua'jie
大冈东街	da'gang'dong'jie
建设大道中	jian'she'da'dao'zhong
十二岭路	shi'er'ling'lu
丛云路	cong'yun'lu
永泰新村总站	yong'tai'xin'cun'zong'zhan
永康路	yong'kang'lu
永康路中	yong'kang'lu'zhong
集贤苑总站	ji'xian'yuan'zong'zhan
百顺北路	bai'shun'bei'lu
华师附中新世界学校	hua'shi'fu'zhong'xin'shi'jie'xue'xiao
市动物卫生监督所	shi'dong'wu'wei'sheng'jian'du'suo
空港大道北	kong'gang'da'dao'bei
公园路	gong'yuan'lu
庆丰一路	qing'feng'yi'lu
庆丰一路口	qing'feng'yi'lu'kou
庆丰二路口	qing'feng'er'lu'kou
石庆路北	shi'qing'lu'bei
庆槎路北	qing'cha'lu'bei
庆隆路口	qing'long'lu'kou
庆隆路中	qing'long'lu'zhong
兴隆东路口	xing'long'dong'lu'kou
石井总站	shi'jing'zong'zhan
汇侨路	hui'qiao'lu
大埔东街	da'bu'dong'jie
松柏路中	song'bai'lu'zhong
小坪东路中	xiao'ping'dong'lu'zhong
小坪东路	xiao'ping'dong'lu
石槎路中	shi'cha'lu'zhong
龙归城总站	long'gui'cheng'zong'zhan
龙归城北	long'gui'cheng'bei
龙归城南	long'gui'cheng'nan
钟永路	zhong'yong'lu
龙兴西路	long'xing'xi'lu
龙兴西路西	long'xing'xi'lu'xi
行知学院	xing'zhi'xue'yuan
龙河路口	long'he'lu'kou
龙归华侨医院	long'gui'hua'qiao'yi'yuan
龙归墟	long'gui'xu
北村桥	bei'cun'qiao
官海街口	guan'hai'jie'kou
园夏村南	yuan'xia'cun'nan
龙归总站	long'gui'zong'zhan
兆丰路	zhao'feng'lu
地铁石井站	di'tie'shi'jing'zhan
黄丽街	huang'li'jie
广东华侨中学	guang'dong'hua'qiao'zhong'xue
广附实验中学	guang'fu'shi'yan'zhong'xue
沙凤二路	sha'feng'er'lu
沙凤三路	sha'feng'san'lu
金刚禅寺	jin'gang'chan'si
浔峰花苑	xun'feng'hua'yuan
藤业一路西	teng'ye'yi'lu'xi
藤业一路中	teng'ye'yi'lu'zhong
环洲二路	huan'zhou'er'lu
地铁沙贝站	di'tie'sha'bei'zhan
金沙洲码头	jin'sha'zhou'ma'tou
深井码头	shen'jing'ma'tou
安新路北	an'xin'lu'bei
安新路	an'xin'lu
安新路南	an'xin'lu'nan
黄埔军校	huang'pu'jun'xiao
护林路	hu'lin'lu
黄埔体育中心公交站场	huang'pu'ti'yu'zhong'xin'gong'jiao'zhan'chang
黄村康体路	huang'cun'kang'ti'lu
奥林匹克中心南门	ao'lin'pi'ke'zhong'xin'nan'men
吉岐路	ji'qi'lu
岐山村	qi'shan'cun
姬堂商业街	ji'tang'shang'ye'jie
旧围村口	jiu'wei'cun'kou
新围村	xin'wei'cun
大田路	da'tian'lu
双岗天桥	shuang'gang'tian'qiao
文船生活区东区	wen'chuan'sheng'huo'qu'dong'qu
广新路	guang'xin'lu
文冲社区	wen'chong'she'qu
广新路中	guang'xin'lu'zhong
广新路口	guang'xin'lu'kou
红山	hong'shan
鹿步牌坊	lu'bu'pai'fang
鹿步大路	lu'bu'da'lu
鹿步剧场	lu'bu'ju'chang
鹿步大街	lu'bu'da'jie
鹿步新路	lu'bu'xin'lu
南宁小区	nan'ning'xiao'qu
新南大街口	xin'nan'da'jie'kou
鹿步总站	lu'bu'zong'zhan
南岗西路口	nan'gang'xi'lu'kou
荔枝园西	li'zhi'yuan'xi
南山公园	nan'shan'gong'yuan
南园花园大街	nan'yuan'hua'yuan'da'jie
南岗西路南	nan'gang'xi'lu'nan
南岗码头	nan'gang'ma'tou
碧山村总站	bi'shan'cun'zong'zhan
荔香路	li'xiang'lu
印象黄埔文化创意园	yin'xiang'huang'pu'wen'hua'chuang'yi'yuan
小迳路口	xiao'jing'lu'kou
西基路尾	xi'ji'lu'wei
金友街	jin'you'jie
东基村	dong'ji'cun
蕉园路西	jiao'yuan'lu'xi
蕉园路中	jiao'yuan'lu'zhong
蕉园路东	jiao'yuan'lu'dong
夏园东路	xia'yuan'dong'lu
滨河路	bin'he'lu
沙湾一街	sha'wan'yi'jie
沙湾三街	sha'wan'san'jie
沙湾五街	sha'wan'wu'jie
青年路东	qing'nian'lu'dong
创业路东	chuang'ye'lu'dong
港讯小区	gang'xun'xiao'qu
金碧路	jin'bi'lu
金友街路口	jin'you'jie'lu'kou
镇龙新总站	zhen'long'xin'zong'zhan
新围村路口	xin'wei'cun'lu'kou
新田村口	xin'tian'cun'kou
江新路	jiang'xin'lu
灯布社	deng'bu'she
新田居委会	xin'tian'ju'wei'hui
新田村	xin'tian'cun
上屋	shang'wu
洋田村	yang'tian'cun
佛子庄	fo'zi'zhuang
大迳村口	da'jing'cun'kou
中泰天境花园	zhong'tai'tian'jing'hua'yuan
九龙二小九楼分校	jiu'long'er'xiao'jiu'lou'fen'xiao
镇龙水厂	zhen'long'shui'chang
镇龙邮局	zhen'long'you'ju
大汾田公路口	da'fen'tian'gong'lu'kou
潘屋	pan'wu
福洞小学	fu'dong'xiao'xue
福洞村	fu'dong'cun
福洞村尾	fu'dong'cun'wei
旧福山村委总站	jiu'fu'shan'cun'wei'zong'zhan
新屋	xin'wu
大坦居委	da'tan'ju'wei
陈塘社	chen'tang'she
九龙二小大坦分校	jiu'long'er'xiao'da'tan'fen'xiao
边潭村	bian'tan'cun
麦村村委	mai'cun'cun'wei
大心田村	da'xin'tian'cun
果园村	guo'yuan'cun
龙江村总站	long'jiang'cun'zong'zhan
健康港总站	jian'kang'gang'zong'zhan
汇盛路	hui'sheng'lu
长平村	chang'ping'cun
旺旺食品有限公司	wang'wang'shi'pin'you'xian'gong'si
永和总站	yong'he'zong'zhan
穗港码头总站	sui'gang'ma'tou'zong'zhan
创业路西	chuang'ye'lu'xi
东晖广场	dong'hui'guang'chang
奥体南路口	ao'ti'nan'lu'kou
黄村训练基地	huang'cun'xun'lian'ji'di
广东体育职业学院	guang'dong'ti'yu'zhi'ye'xue'yuan
奥体路	ao'ti'lu
南云三路口	nan'yun'san'lu'kou
南云三路中	nan'yun'san'lu'zhong
科林路总站	ke'lin'lu'zong'zhan
黄陂社区总站	huang'po'she'qu'zong'zhan
八斗村总站	ba'dou'cun'zong'zhan
长平路口	chang'ping'lu'kou
小塱	xiao'lang
小塱村口	xiao'lang'cun'kou
骏成路东	jun'cheng'lu'dong
海中村总站	hai'zhong'cun'zong'zhan
海中小学	hai'zhong'xiao'xue
海中八路	hai'zhong'ba'lu
百亩园	bai'mu'yuan
海中北路	hai'zhong'bei'lu
东西部扶贫市场	dong'xi'bu'fu'pin'shi'chang
高岗路	gao'gang'lu
沿河路总站	yan'he'lu'zong'zhan
春园路	chun'yuan'lu
东晖路	dong'hui'lu
宝石路	bao'shi'lu
青年路中	qing'nian'lu'zhong
青年路西	qing'nian'lu'xi
南岗万达广场	nan'gang'wan'da'guang'chang
水南大道西	shui'nan'da'dao'xi
水南大道中	shui'nan'da'dao'zhong
西街中	xi'jie'zhong
水南村	shui'nan'cun
悦兴综合市场	yue'xing'zong'he'shi'chang
翡翠绿洲	fei'cui'lyu'zhou
陈家林	chen'jia'lin
布岭路口	bu'ling'lu'kou
黄旗山路	huang'qi'shan'lu
来安一街	lai'an'yi'jie
贤江路口	xian'jiang'lu'kou
来安二街	lai'an'er'jie
贤江路	xian'jiang'lu
九佛二中	jiu'fu'er'zhong
洪村	hong'cun
黄田大道中	huang'tian'da'dao'zhong
黄田村委	huang'tian'cun'wei
黄田村	huang'tian'cun
长庚村口	chang'geng'cun'kou
蟹庄村	xie'zhuang'cun
枫下二社	feng'xia'er'she
旧市场路口	jiu'shi'chang'lu'kou
镇龙二中	zhen'long'er'zhong
迳头三社	jing'tou'san'she
迳头二社	jing'tou'er'she
迳头二小分校	jing'tou'er'xiao'fen'xiao
迳头六社	jing'tou'liu'she
迳头九社总站	jing'tou'jiu'she'zong'zhan
赵溪路	zhao'xi'lu
远安路南	yuan'an'lu'nan
天园路	tian'yuan'lu
怡趣路	yi'qu'lu
江怡路	jiang'yi'lu
晓港西马路	xiao'gang'xi'ma'lu
地铁晓港站	di'tie'xiao'gang'zhan
金禧路西	jin'xi'lu'xi
江怡路口	jiang'yi'lu'kou
北山总站	bei'shan'zong'zhan
北山公园	bei'shan'gong'yuan
仑头路口	lun'tou'lu'kou
仑头村总站	lun'tou'cun'zong'zhan
仑头公园	lun'tou'gong'yuan
穗华中学	sui'hua'zhong'xue
仑头村委会	lun'tou'cun'wei'hui
地铁东晓南站	di'tie'dong'xiao'nan'zhan
瑞南路口	rui'nan'lu'kou
瑞南路	rui'nan'lu
瑞宝南路	rui'bao'nan'lu
凤康路	feng'kang'lu
逸景西路总站	yi'jing'xi'lu'zong'zhan
逸景路口	yi'jing'lu'kou
江贝村运动场	jiang'bei'cun'yun'dong'chang
江贝村	jiang'bei'cun
艺苑南路	yi'yuan'nan'lu
艺苑南路口	yi'yuan'nan'lu'kou
碧映路东	bi'ying'lu'dong
碧映路西	bi'ying'lu'xi
赤岗西	chi'gang'xi
乐敦路口	le'dun'lu'kou
珠江花城总站	zhu'jiang'hua'cheng'zong'zhan
后滘西大街	hou'jiao'xi'da'jie
森语大街路口	sen'yu'da'jie'lu'kou
后滘村口	hou'jiao'cun'kou
上涌果树公园南门	shang'yong'guo'shu'gong'yuan'nan'men
南洲北	nan'zhou'bei
地铁东晓南站	di'tie'dong'xiao'nan'zhan
赤沙路	chi'sha'lu
赤沙茅园岗大街	chi'sha'mao'yuan'gang'da'jie
石伦里	shi'lun'li
广东财经大学北门	guang'dong'cai'jing'da'xue'bei'men
南丰汇总站	nan'feng'hui'zong'zhan
海琴湾总站	hai'qin'wan'zong'zhan
新市头路	xin'shi'tou'lu
新市头路南	xin'shi'tou'lu'nan
金属冶炼厂	jin'shu'ye'lian'chang
小洲南路	xiao'zhou'nan'lu
海珠湿地公园南门	hai'zhu'shi'di'gong'yuan'nan'men
新滘西路西	xin'jiao'xi'lu'xi
沙溪村口	sha'xi'cun'kou
泰宁大街	tai'ning'da'jie
地铁江泰路站总站	di'tie'jiang'tai'lu'zhan'zong'zhan
机场立交总站	ji'chang'li'jiao'zong'zhan
东风大酒店	dong'feng'da'jiu'dian
梓元岗路中	zi'yuan'gang'lu'zhong
祥元路	xiang'yuan'lu
地铁三元里站	di'tie'san'yuan'li'zhan
草庄村	cao'zhuang'cun
草庄东路口	cao'zhuang'dong'lu'kou
草庄南路	cao'zhuang'nan'lu
细沥村	xi'li'cun
玉虚宫	yu'xu'gong
大沥村	da'li'cun
田心村口	tian'xin'cun'kou
地铁太和站	di'tie'tai'he'zhan
丰泰小区路口	feng'tai'xiao'qu'lu'kou
石湖村东	shi'hu'cun'dong
朝亮南路	chao'liang'nan'lu
石湖村	shi'hu'cun
石湖镇东路总站	shi'hu'zhen'dong'lu'zong'zhan
太营路口	tai'ying'lu'kou
神山	shen'shan
神山商贸城	shen'shan'shang'mao'cheng
大岭南路	da'ling'nan'lu
松园社	song'yuan'she
东昌社	dong'chang'she
大岭村总站	da'ling'cun'zong'zhan
乌溪村总站	wu'xi'cun'zong'zhan
乌溪路	wu'xi'lu
地铁竹料站	di'tie'zhu'liao'zhan
良田路口	liang'tian'lu'kou
竹料大道	zhu'liao'da'dao
红旗路南	hong'qi'lu'nan
红旗路	hong'qi'lu
红旗路北	hong'qi'lu'bei
红旗中心	hong'qi'zhong'xin
红旗童庄中心街路口	hong'qi'tong'zhuang'zhong'xin'jie'lu'kou
寮采路	liao'cai'lu
寮竹	liao'zhu
寮采南路口	liao'cai'nan'lu'kou
寮采中路口	liao'cai'zhong'lu'kou
花田路口	hua'tian'lu'kou
北向庄	bei'xiang'zhuang
寮采北路	liao'cai'bei'lu
寮采总站	liao'cai'zong'zhan
江高总站	jiang'gao'zong'zhan
凤翔北路	feng'xiang'bei'lu
田南路	tian'nan'lu
白云学院	bai'yun'xue'yuan
秋鹿路	qiu'lu'lu
金沙南路	jin'sha'nan'lu
刘家沙	liu'jia'sha
江同路	jiang'tong'lu
南方医院江高院区	nan'fang'yi'yuan'jiang'gao'yuan'qu
夏花三路	xia'hua'san'lu
泉溪	quan'xi
塘贝	tang'bei
水沥	shui'li
双岗村	shuang'gang'cun
双岗向南庄	shuang'gang'xiang'nan'zhuang
新楼村	xin'lou'cun
江高长兴路口	jiang'gao'chang'xing'lu'kou
长岗村总站	zhang'gang'cun'zong'zhan
岗贝路	gang'bei'lu
乐嘉路中	le'jia'lu'zhong
乐嘉路西	le'jia'lu'xi
地铁三元里站	di'tie'san'yuan'li'zhan
地铁三元里站	di'tie'san'yuan'li'zhan
乐陶街口	le'tao'jie'kou
凤鸣路	feng'ming'lu
庆槎路	qing'cha'lu
兴隆中路	xing'long'zhong'lu
亭石南路口	ting'shi'nan'lu'kou
亭石南路南	ting'shi'nan'lu'nan
石门街	shi'men'jie
亭石南路中	ting'shi'nan'lu'zhong
亭石南路	ting'shi'nan'lu
亭石南路北	ting'shi'nan'lu'bei
杨梅岗	yang'mei'gang
石井朝阳村	shi'jing'zhao'yang'cun
滘心大道	jiao'xin'da'dao
亭石北路口	ting'shi'bei'lu'kou
西洲北路尾总站	xi'zhou'bei'lu'wei'zong'zhan
机电技工学校	ji'dian'ji'gong'xue'xiao
邮政物流中心	you'zheng'wu'liu'zhong'xin
华海街口	hua'hai'jie'kou
西洲北路	xi'zhou'bei'lu
德棠路	de'tang'lu
兴龙一新村	xing'long'yi'xin'cun
藤业路	teng'ye'lu
沙凤一路西	sha'feng'yi'lu'xi
沙凤一路中	sha'feng'yi'lu'zhong
高桥大街口	gao'qiao'da'jie'kou
高桥大街	gao'qiao'da'jie
富园路	fu'yuan'lu
彭城东路	peng'cheng'dong'lu
环洲二路北	huan'zhou'er'lu'bei
景泰直街	jing'tai'zhi'jie
白兰花园	bai'lan'hua'yuan
云龙路口	yun'long'lu'kou
民航子弟学校	min'hang'zi'di'xue'xiao
云城东路	yun'cheng'dong'lu
地铁飞翔公园站	di'tie'fei'xiang'gong'yuan'zhan
云城南二路	yun'cheng'nan'er'lu
北站	bei'zhan
北站路	bei'zhan'lu
华泉社区	hua'quan'she'qu
北站社区	bei'zhan'she'qu
明泉街	ming'quan'jie
村前大街	cun'qian'da'jie
莲涌街	lian'yong'jie
前进北街	qian'jin'bei'jie
瑶池西街口	yao'chi'xi'jie'kou
前进大街口	qian'jin'da'jie'kou
向阳大街口	xiang'yang'da'jie'kou
瑶台西街	yao'tai'xi'jie
王圣堂牌坊	wang'sheng'tang'pai'fang
矿泉街道办	kuang'quan'jie'dao'ban
广州大学总站	guang'zhou'da'xue'zong'zhan
飞鹅路	fei'e'lu
政民路	zheng'min'lu
政通路	zheng'tong'lu
太和岗路	tai'he'gang'lu
太和岗路口	tai'he'gang'lu'kou
淘金东路	tao'jin'dong'lu
淘金路	tao'jin'lu
淘金路口	tao'jin'lu'kou
广州血液中心	guang'zhou'xue'ye'zhong'xin
淘金街	tao'jin'jie
淘金北路	tao'jin'bei'lu
黄华路口	huang'hua'lu'kou
黄华路	huang'hua'lu
北较场路	bei'jiao'chang'lu
北较场横路	bei'jiao'chang'heng'lu
建设横马路	jian'she'heng'ma'lu
西胜街总站	xi'sheng'jie'zong'zhan
西胜街	xi'sheng'jie
三山科创中心总站	san'shan'ke'chuang'zhong'xin'zong'zhan
长江路东	chang'jiang'lu'dong
科丰路	ke'feng'lu
创智路	chuang'zhi'lu
三山大道东	san'shan'da'dao'dong
广雅路	guang'ya'lu
西村	xi'cun
东漖教师新村	dong'jiao'jiao'shi'xin'cun
花地湾地铁站	hua'di'wan'di'tie'zhan
逸景路西	yi'jing'lu'xi
江南西路	jiang'nan'xi'lu
悦景路西	yue'jing'lu'xi
玉树新村社区	yu'shu'xin'cun'she'qu
渔中路	yu'zhong'lu
柯木塱西路	ke'mu'lang'xi'lu
柯木塱大坪街	ke'mu'lang'da'ping'jie
凤凰中学	feng'huang'zhong'xue
元新街	yuan'xin'jie
思成路北	si'cheng'lu'bei
天顺路	tian'shun'lu
地铁天河智慧城站	di'tie'tian'he'zhi'hui'cheng'zhan
地铁龙洞站总站	di'tie'long'dong'zhan'zong'zhan
菠萝山	bo'luo'shan
水口村	shui'kou'cun
黄屋村	huang'wu'cun
渔沙坦总站	yu'sha'tan'zong'zhan
龙洞牌坊	long'dong'pai'fang
渔兴东路	yu'xing'dong'lu
凤凰街文化站	feng'huang'jie'wen'hua'zhan
高普路北	gao'pu'lu'bei
高普路高科路口	gao'pu'lu'gao'ke'lu'kou
高普路中	gao'pu'lu'zhong
光宝路	guang'bao'lu
创新路南	chuang'xin'lu'nan
地铁车陂南站总站	di'tie'che'bei'nan'zhan'zong'zhan
沐陂村	mu'bei'cun
沐陂村口	mu'bei'cun'kou
沐陂南路口	mu'bei'nan'lu'kou
沐陂路	mu'bei'lu
科韵路总站	ke'yun'lu'zong'zhan
柯木塱南路北	ke'mu'lang'nan'lu'bei
柯木塱南路	ke'mu'lang'nan'lu
柯木塱南路南	ke'mu'lang'nan'lu'nan
高唐路中	gao'tang'lu'zhong
地铁天河智慧城站	di'tie'tian'he'zhi'hui'cheng'zhan
黄村总站	huang'cun'zong'zhan
渔沙坦总站	yu'sha'tan'zong'zhan
梅园路总站	mei'yuan'lu'zong'zhan
梅园路西	mei'yuan'lu'xi
梅园路中	mei'yuan'lu'zhong
梅园路东	mei'yuan'lu'dong
地铁梅花园站	di'tie'mei'hua'yuan'zhan
怡新路	yi'xin'lu
怡新路口	yi'xin'lu'kou
元岗横路中	yuan'gang'heng'lu'zhong
华成路总站	hua'cheng'lu'zong'zhan
广州国际金融中心	guang'zhou'guo'ji'jin'rong'zhong'xin
骏逸苑	jun'yi'yuan
跑马地花园	pao'ma'di'hua'yuan
花城大道	hua'cheng'da'dao
珠江公园北门	zhu'jiang'gong'yuan'bei'men
珠江西路北	zhu'jiang'xi'lu'bei
珠江西路中	zhu'jiang'xi'lu'zhong
太和中学	tai'he'zhong'xue
良种猪场	liang'zhong'zhu'chang
森林公园路口	sen'lin'gong'yuan'lu'kou
金盆村委	jin'pen'cun'wei
光明村	guang'ming'cun
陈洞村	chen'dong'cun
良田一小	liang'tian'yi'xiao
华坑村	hua'keng'cun
沙田村总站	sha'tian'cun'zong'zhan
科韵立交西	ke'yun'li'jiao'xi
员村西街中	yuan'cun'xi'jie'zhong
黄庄	huang'zhuang
沙太货运站	sha'tai'huo'yun'zhan
太和路口	tai'he'lu'kou
建业北路西	jian'ye'bei'lu'xi
沙亭南路	sha'ting'nan'lu
太和总站	tai'he'zong'zhan
天泰二路	tian'tai'er'lu
车陂西路	che'bei'xi'lu
江高南岗村总站	jiang'gao'nan'gang'cun'zong'zhan
南贤路口	nan'xian'lu'kou
凤翔中路	feng'xiang'zhong'lu
江高路口	jiang'gao'lu'kou
江高	jiang'gao
大松岗	da'song'gang
江人路	jiang'ren'lu
江丰路口	jiang'feng'lu'kou
江村大桥北	jiang'cun'da'qiao'bei
江村大桥南	jiang'cun'da'qiao'nan
桃源	tao'yuan
大布路口	da'bu'lu'kou
均禾大道中	jun'he'da'dao'zhong
新科	xin'ke
望岗大道	wang'gang'da'dao
地铁嘉禾望岗站总站	di'tie'jia'he'wang'gang'zhan'zong'zhan
长红	chang'hong
竹仔园	zhu'zi'yuan
北村	bei'cun
柏塘	bai'tang
蒲鱼庄	pu'yu'zhuang
白米布	bai'mi'bu
秀水塘	xiu'shui'tang
鹤亭	he'ting
人和车站	ren'he'che'zhan
人和墟总站	ren'he'xu'zong'zhan
人和墟	ren'he'xu
人和华侨医院	ren'he'hua'qiao'yi'yuan
凤和庄	feng'he'zhuang
和瑞路口	he'rui'lu'kou
和福路	he'fu'lu
和瑞路总站	he'rui'lu'zong'zhan
太成村	tai'cheng'cun
云埔四路	yun'bu'si'lu
摇田河大街	yao'tian'he'da'jie
新业路	xin'ye'lu
新业路中	xin'ye'lu'zhong
石井总站	shi'jing'zong'zhan
石溪	shi'xi
郭塘路口	guo'tang'lu'kou
郭塘货场	guo'tang'huo'chang
郭塘	guo'tang
大岭路口	da'ling'lu'kou
神山大道西	shen'shan'da'dao'xi
江村墟	jiang'cun'xu
大朗总站	da'lang'zong'zhan
大朗火车站	da'lang'huo'che'zhan
大朗市场	da'lang'shi'chang
大朗中学	da'lang'zhong'xue
陆祖庙	lu'zu'miao
大朗中路	da'lang'zhong'lu
江高小塘	jiang'gao'xiao'tang
高塘市场	gao'tang'shi'chang
江高小塘	jiang'gao'xiao'tang
江高总站	jiang'gao'zong'zhan
长红村总站	chang'hong'cun'zong'zhan
芳村葵蓬总站	fang'cun'kui'peng'zong'zhan
嵘都花园	rong'dou'hua'yuan
葵蓬西滘村	kui'peng'xi'jiao'cun
海中高得	hai'zhong'gao'de
沙尾水闸	sha'wei'shui'zha
沙尾桥底	sha'wei'qiao'di
机电技工学校	ji'dian'ji'gong'xue'xiao
长红村总站	chang'hong'cun'zong'zhan
广从路	guang'cong'lu
石湖村口	shi'hu'cun'kou
营溪村	ying'xi'cun
广和庄	guang'he'zhuang
太营路	tai'ying'lu
太和总站	tai'he'zong'zhan
沙涌南总站	sha'yong'nan'zong'zhan
瑶华街	yao'hua'jie
石岗路口	shi'gang'lu'kou
石岗路	shi'gang'lu
石岗路总站	shi'gang'lu'zong'zhan
上下九步行街	shang'xia'jiu'bu'xing'jie
文昌南路	wen'chang'nan'lu
开萝大道西	kai'luo'da'dao'xi
嘉禾望岗公交枢纽站	jia'he'wang'gang'gong'jiao'shu'niu'zhan
空港大道	kong'gang'da'dao
空港大道中	kong'gang'da'dao'zhong
地铁江夏站	di'tie'jiang'xia'zhan
江夏东二路北	jiang'xia'dong'er'lu'bei
员村	yuan'cun
旭日雅苑	xu'ri'ya'yuan
汇景新城东总站	hui'jing'xin'cheng'dong'zong'zhan
石井总站	shi'jing'zong'zhan
庆丰纺织一路	qing'feng'fang'zhi'yi'lu
广州体育馆总站	guang'zhou'ti'yu'guan'zong'zhan
金信路口	jin'xin'lu'kou
南洲花园	nan'zhou'hua'yuan
陵园西路	ling'yuan'xi'lu
执信南路	zhi'xin'nan'lu
奥体南路总站	ao'ti'nan'lu'zong'zhan
珠村七夕广场	zhu'cun'qi'xi'guang'chang
珠吉街	zhu'ji'jie
东圃珠村总站	dong'pu'zhu'cun'zong'zhan
新市云霄楼	xin'shi'yun'xiao'lou
齐富路	qi'fu'lu
广州大道北总站	guang'zhou'da'dao'bei'zong'zhan
龙怡路	long'yi'lu
香江野生动物世界总站	xiang'jiang'ye'sheng'dong'wu'shi'jie'zong'zhan
太和总站	tai'he'zong'zhan
科技服务中心	ke'ji'fu'wu'zhong'xin
863中心	863'zhong'xin
白云货运站	bai'yun'huo'yun'zhan
增埗桥总站	zeng'bu'qiao'zong'zhan
联和墟	lian'he'xu
黄埔村	huang'pu'cun
大学城总站	da'xue'cheng'zong'zhan
大丰街	da'feng'jie
黄麻村口	huang'ma'cun'kou
黄麻小学	huang'ma'xiao'xue
黄麻社区居委会	huang'ma'she'qu'ju'wei'hui
黄麻村经济合作社	huang'ma'cun'jing'ji'he'zuo'she
黄麻路	huang'ma'lu
八哥村	ba'ge'cun
峨山社总站	e'shan'she'zong'zhan
华兴综合市场	hua'xing'zong'he'shi'chang
长岗村委	zhang'gang'cun'wei
长岗小学	zhang'gang'xiao'xue
岗丰村	gang'feng'cun
永和中队	yong'he'zhong'dui
永和医院	yong'he'yi'yuan
地铁香雪站总站	di'tie'xiang'xue'zhan'zong'zhan
开发区总站	kai'fa'qu'zong'zhan
凤凰城路口	feng'huang'cheng'lu'kou
凯旋门	kai'xuan'men
新塘大道	xin'tang'da'dao
沙村地铁站	sha'cun'di'tie'zhan
新塘三中	xin'tang'san'zhong
悦顺装饰材料城	yue'shun'zhuang'shi'cai'liao'cheng
新康花园	xin'kang'hua'yuan
华馨苑	hua'xin'yuan
水电二局医院	shui'dian'er'ju'yi'yuan
新塘广场	xin'tang'guang'chang
高地街	gao'di'jie
新塘公园	xin'tang'gong'yuan
东华村	dong'hua'cun
铁塔路	tie'ta'lu
东江首府东	dong'jiang'shou'fu'dong
新塘总站	xin'tang'zong'zhan
水西路南	shui'xi'lu'nan
萝岗行政执法综合楼	luo'gang'xing'zheng'zhi'fa'zong'he'lou
开创大道总站	kai'chuang'da'dao'zong'zhan
暹岗村口	xian'gang'cun'kou
育星路	yu'xing'lu
水西路中	shui'xi'lu'zhong
二中	er'zhong
沐陂东路	mu'bei'dong'lu
凌塘新村	ling'tang'xin'cun
康南路北	kang'nan'lu'bei
康南路	kang'nan'lu
长福路总站	zhang'fu'lu'zong'zhan
起云路总站	qi'yun'lu'zong'zhan
员村西街西	yuan'cun'xi'jie'xi
上涌果树公园	shang'yong'guo'shu'gong'yuan
新滘西路	xin'jiao'xi'lu
青年农场	qing'nian'nong'chang
广东白云学院	guang'dong'bai'yun'xue'yuan
登塘村口	deng'tang'cun'kou
新和	xin'he
湴湖	ban'hu
广东工贸职业技术学院	guang'dong'gong'mao'zhi'ye'ji'shu'xue'yuan
地铁马沥站	di'tie'ma'li'zhan
广东机电职业技术学院北门	guang'dong'ji'dian'zhi'ye'ji'shu'xue'yuan'bei'men
钟落潭高校园	zhong'luo'tan'gao'xiao'yuan
长腰岭	zhang'yao'ling
长腰岭	zhang'yao'ling
钟落潭路口	zhong'luo'tan'lu'kou
钟落潭	zhong'luo'tan
地铁钟落潭站	di'tie'zhong'luo'tan'zhan
五龙岗路口	wu'long'gang'lu'kou
安平村	an'ping'cun
竹料路口	zhu'liao'lu'kou
白沙村	bai'sha'cun
乌溪村	wu'xi'cun
大罗村	da'luo'cun
大罗村总站	da'luo'cun'zong'zhan
创新大道北	chuang'xin'da'dao'bei
南岭村总站	nan'ling'cun'zong'zhan
南岭村委	nan'ling'cun'wei
南岭桥头南街口	nan'ling'qiao'tou'nan'jie'kou
百稔庄	bai'ren'zhuang
南方村委	nan'fang'cun'wei
大麦庄	da'mai'zhuang
蚌湖桥南	bang'hu'qiao'nan
蚌湖桥北	bang'hu'qiao'bei
市七十二中学	shi'qi'shi'er'zhong'xue
镇湖村委	zhen'hu'cun'wei
蚌湖路	bang'hu'lu
蚌湖路口	bang'hu'lu'kou
蚌湖市场	bang'hu'shi'chang
建南村	jian'nan'cun
庙仔庄	miao'zi'zhuang
白象岭	bai'xiang'ling
江人路	jiang'ren'lu
环镇东路	huan'zhen'dong'lu
环镇西路	huan'zhen'xi'lu
地铁沙贝站	di'tie'sha'bei'zhan
建设大道口	jian'she'da'dao'kou
泌冲小学	mi'chong'xiao'xue
伯奇桥	bo'qi'qiao
泌二新村	mi'er'xin'cun
沙面横路	sha'mian'heng'lu
共和路口	gong'he'lu'kou
城际海北广场	cheng'ji'hai'bei'guang'chang
江高新楼村总站	jiang'gao'xin'lou'cun'zong'zhan
双岗村口	shuang'gang'cun'kou
水沥村	shui'li'cun
塘贝村	tang'bei'cun
新镇庄	xin'zhen'zhuang
江同东路	jiang'tong'dong'lu
江同路口	jiang'tong'lu'kou
学苑路	xue'yuan'lu
大田商业步行街	da'tian'shang'ye'bu'xing'jie
大田小学	da'tian'xiao'xue
大田村总站	da'tian'cun'zong'zhan
广东青年职业学院总站	guang'dong'qing'nian'zhi'ye'xue'yuan'zong'zhan
现龙街	xian'long'jie
障岗村	zhang'gang'cun
五龙岗	wu'long'gang
广陈路	guang'chen'lu
天成庄路	tian'cheng'zhuang'lu
良园一路口	liang'yuan'yi'lu'kou
良田南路	liang'tian'nan'lu
良田环村西路	liang'tian'huan'cun'xi'lu
良沙路	liang'sha'lu
金盆北路口	jin'pen'bei'lu'kou
金盆村骑马场	jin'pen'cun'qi'ma'chang
士官训练学校	shi'guan'xun'lian'xue'xiao
金盆金沙路口	jin'pen'jin'sha'lu'kou
白沙村总站	bai'sha'cun'zong'zhan
龙归竹木市场	long'gui'zhu'mu'shi'chang
龙兴西路	long'xing'xi'lu
东平村钟屋路口	dong'ping'cun'zhong'wu'lu'kou
地铁嘉禾望岗站	di'tie'jia'he'wang'gang'zhan
地铁嘉禾望岗站总站	di'tie'jia'he'wang'gang'zhan'zong'zhan
金沙洲码头	jin'sha'zhou'ma'tou
草场居委会	cao'chang'ju'wei'hui
啟明工业区	qi'ming'gong'ye'qu
蟹坑村	xie'keng'cun
草场村	cao'chang'cun
西华寺	xi'hua'si
西华村总站	xi'hua'cun'zong'zhan
汇才二街	hui'cai'er'jie
汇才二街口	hui'cai'er'jie'kou
谷诒路	gu'yi'lu
谷诒路口	gu'yi'lu'kou
汇才一街	hui'cai'yi'jie
涛乐街	tao'le'jie
彩滨北路	cai'bin'bei'lu
沙亭广兴路	sha'ting'guang'xing'lu
沙亭北路	sha'ting'bei'lu
沙亭岗村口	sha'ting'gang'cun'kou
石湖部队	shi'hu'bu'dui
广外总站	guang'wai'zong'zhan
广外南路口	guang'wai'nan'lu'kou
云城中二路	yun'cheng'zhong'er'lu
云城西路	yun'cheng'xi'lu
地铁萧岗站	di'tie'xiao'gang'zhan
广东外语外贸大学公开学院总站	guang'dong'wai'yu'wai'mao'da'xue'gong'kai'xue'yuan'zong'zhan
云城西路	yun'cheng'xi'lu
地铁飞翔公园站	di'tie'fei'xiang'gong'yuan'zhan
云城东路	yun'cheng'dong'lu
瑶华街口	yao'hua'jie'kou
走马岗路	zou'ma'gang'lu
梓元岗	zi'yuan'gang
岗头大街	gang'tou'da'jie
云城西路	yun'cheng'xi'lu
云城南四路	yun'cheng'nan'si'lu
航云北街	hang'yun'bei'jie
南云东街	nan'yun'dong'jie
棠安路	tang'an'lu
南社	nan'she
棠新路	tang'xin'lu
保利紫云	bao'li'zi'yun
南航新村	nan'hang'xin'cun
大埔村	da'bu'cun
水边街	shui'bian'jie
时代花园	shi'dai'hua'yuan
松云街口	song'yun'jie'kou
嘉禾长湴街总站	jia'he'zhang'ban'jie'zong'zhan
宋屋街	song'wu'jie
双和工业区二路	shuang'he'gong'ye'qu'er'lu
双和东街	shuang'he'dong'jie
双和大马路中	shuang'he'da'ma'lu'zhong
南岭工业区五横路口	nan'ling'gong'ye'qu'wu'heng'lu'kou
双和大马路西	shuang'he'da'ma'lu'xi
长红广场	chang'hong'guang'chang
长湴北街	zhang'ban'bei'jie
长湴街	zhang'ban'jie
均禾上村	jun'he'shang'cun
武警广州指挥学院正门	wu'jing'guang'zhou'zhi'hui'xue'yuan'zheng'men
广东警官学院	guang'dong'jing'guan'xue'yuan
文盛庄	wen'sheng'zhuang
广州市第八医院	guang'zhou'shi'di'ba'yi'yuan
双和三路	shuang'he'san'lu
石马总站	shi'ma'zong'zhan
桃红西街	tao'hong'xi'jie
黄石北路	huang'shi'bei'lu
云城东路南	yun'cheng'dong'lu'nan
地铁白云大道北站	di'tie'bai'yun'da'dao'bei'zhan
尖彭路东	jian'peng'lu'dong
省交警指挥中心	sheng'jiao'jing'zhi'hui'zhong'xin
彭边村东	peng'bian'cun'dong
彭边村西	peng'bian'cun'xi
尖彭路口	jian'peng'lu'kou
黄边北路总站	huang'bian'bei'lu'zong'zhan
黄边北路西	huang'bian'bei'lu'xi
黄边南街	huang'bian'nan'jie
地铁江夏站	di'tie'jiang'xia'zhan
时代玫瑰园	shi'dai'mei'gui'yuan
机场西路尖彭路口	ji'chang'xi'lu'jian'peng'lu'kou
康卫路	kang'wei'lu
新顺路北	xin'shun'lu'bei
新顺路南	xin'shun'lu'nan
白云大道北地铁站	bai'yun'da'dao'bei'di'tie'zhan
金穗路总站	jin'sui'lu'zong'zhan
龙溪村委总站	long'xi'cun'wei'zong'zhan
南边村	nan'bian'cun
新丽路	xin'li'lu
凤西二路	feng'xi'er'lu
荟贤路	hui'xian'lu
集安街	ji'an'jie
花都雅居乐汇通广场总站	hua'du'ya'ju'le'hui'tong'guang'chang'zong'zhan
秀雅学校	xiu'ya'xue'xiao
雅居乐锦城花园	ya'ju'le'jin'cheng'hua'yuan
三东大道西	san'dong'da'dao'xi
大运公司	da'yun'gong'si
大运公寓	da'yun'gong'yu
花都杨屋汽车站	hua'du'yang'wu'qi'che'zhan
车辆厂技校	che'liang'chang'ji'xiao
公安办证大厅	gong'an'ban'zheng'da'ting
豪景苑	hao'jing'yuan
梅花居委	mei'hua'ju'wei
人民公园南门	ren'min'gong'yuan'nan'men
花都区国税局	hua'du'qu'guo'shui'ju
骏壹万邦	jun'yi'wan'bang
骏威小学	jun'wei'xiao'xue
大运家园	da'yun'jia'yuan
雅居乐	ya'ju'le
马鞍山公园西门	ma'an'shan'gong'yuan'xi'men
田美新村	tian'mei'xin'cun
润龙里	run'long'li
莲塘南	lian'tang'nan
清布中学	qing'bu'zhong'xue
中恒商业广场	zhong'heng'shang'ye'guang'chang
合和新城	he'he'xin'cheng
清布	qing'bu
白鳝塘	bai'shan'tang
鹤龙五路口	he'long'wu'lu'kou
北太路西	bei'tai'lu'xi
北太路	bei'tai'lu
北太路中	bei'tai'lu'zhong
民营科技园门口	min'ying'ke'ji'yuan'men'kou
太营路口	tai'ying'lu'kou
广花五路路口	guang'hua'wu'lu'lu'kou
东镜路口	dong'jing'lu'kou
岑境村	cen'jing'cun
花都美居中心	hua'du'mei'ju'zhong'xin
三向村	san'xiang'cun
花城南路	hua'cheng'nan'lu
新湖大厦	xin'hu'da'sha
丽美酒店	li'mei'jiu'dian
新世纪广场东	xin'shi'ji'guang'chang'dong
东华庄	dong'hua'zhuang
五华直街	wu'hua'zhi'jie
星城	xing'cheng
广州北站	guang'zhou'bei'zhan
马房三街	ma'fang'san'jie
旧国光厂	jiu'guo'guang'chang
东雅图酒店	dong'ya'tu'jiu'dian
新雅街道办	xin'ya'jie'dao'ban
雅瑶医院	ya'yao'yi'yuan
雅瑶市场	ya'yao'shi'chang
新华街道办	xin'hua'jie'dao'ban
花都区卫生局	hua'du'qu'wei'sheng'ju
新华市场	xin'hua'shi'chang
金城大厦	jin'cheng'da'sha
布心	bu'xin
布心村	bu'xin'cun
新街小学	xin'jie'xiao'xue
花都钟村	hua'du'zhong'cun
万景峰西门	wan'jing'feng'xi'men
望岗村	wang'gang'cun
天马河公馆	tian'ma'he'gong'guan
万科天景花园	wan'ke'tian'jing'hua'yuan
荔红南路	li'hong'nan'lu
颐养院	yi'yang'yuan
荔红路总站	li'hong'lu'zong'zhan
江人路口	jiang'ren'lu'kou
蚌湖	bang'hu
新联村西	xin'lian'cun'xi
新联村	xin'lian'cun
新联村东	xin'lian'cun'dong
黄榜岭	huang'bang'ling
方华公路	fang'hua'gong'lu
大巷工业区	da'xiang'gong'ye'qu
方石村	fang'shi'cun
人和聚贤街	ren'he'ju'xian'jie
广塘	guang'tang
广岭	guang'ling
清布墟	qing'bu'xu
团结村	tuan'jie'cun
南洋庄	nan'yang'zhuang
龙口	long'kou
东湖安置区	dong'hu'an'zhi'qu
小布	xiao'bu
南门	nan'men
坪山②	ping'shan
花都一中	hua'du'yi'zhong
花都音像厂	hua'du'yin'xiang'chang
两龙市场	liang'long'shi'chang
南岭路	nan'ling'lu
两龙南街	liang'long'nan'jie
花都两龙总站	hua'du'liang'long'zong'zhan
毕村	bi'cun
城际花都站	cheng'ji'hua'du'zhan
广州北站	guang'zhou'bei'zhan
天马河	tian'ma'he
古楼村	gu'lou'cun
金湖大酒店	jin'hu'da'jiu'dian
花都区实验中学	hua'du'qu'shi'yan'zhong'xue
横潭路口	heng'tan'lu'kou
横潭牌坊	heng'tan'pai'fang
红珠路口	hong'zhu'lu'kou
培新中学	pei'xin'zhong'xue
花都湖总站	hua'du'hu'zong'zhan
秀全公园	xiu'quan'gong'yuan
花都区人民医院	hua'du'qu'ren'min'yi'yuan
人和总站	ren'he'zong'zhan
云峰花园	yun'feng'hua'yuan
国光厂	guo'guang'chang
国光厂宿舍	guo'guang'chang'su'she
东莞庄	dong'guan'zhuang
永利路口	yong'li'lu'kou
朗悦君廷	lang'yue'jun'ting
财富工业园	cai'fu'gong'ye'yuan
邦一工业园	bang'yi'gong'ye'yuan
石塘卫生站	shi'tang'wei'sheng'zhan
石塘水泥厂	shi'tang'shui'ni'chang
中心社	zhong'xin'she
东镜市场	dong'jing'shi'chang
东镜	dong'jing
花都富力金港城总站	hua'du'fu'li'jin'gang'cheng'zong'zhan
先科一路	xian'ke'yi'lu
机械城	ji'xie'cheng
维翔公司	wei'xiang'gong'si
金谷南路	jin'gu'nan'lu
大塘中学	da'tang'zhong'xue
金田工业区	jin'tian'gong'ye'qu
七星路口	qi'xing'lu'kou
花东派出所	hua'dong'pai'chu'suo
推广车站	tui'guang'che'zhan
花东镇政府	hua'dong'zhen'zheng'fu
花东市场	hua'dong'shi'chang
飞粤大道北	fei'yue'da'dao'bei
飞粤大道中	fei'yue'da'dao'zhong
飞粤大道南	fei'yue'da'dao'nan
广州国际物流中心	guang'zhou'guo'ji'wu'liu'zhong'xin
1号航站楼	1'hao'hang'zhan'lou
高增一村	gao'zeng'yi'cun
人和华成路口	ren'he'hua'cheng'lu'kou
东华村	dong'hua'cun
方华路口	fang'hua'lu'kou
1号候机楼	1'hao'hou'ji'lou
花都北兴汽车站总站	hua'du'bei'xing'qi'che'zhan'zong'zhan
中兴市场	zhong'xing'shi'chang
莘田工业区	shen'tian'gong'ye'qu
莘田村委	shen'tian'cun'wei
莘田小学	shen'tian'xiao'xue
三联路口	san'lian'lu'kou
长沙埔村委	chang'sha'bu'cun'wei
八十一中学	ba'shi'yi'zhong'xue
钟落潭医院	zhong'luo'tan'yi'yuan
白云社会福利服务中心	bai'yun'she'hui'fu'li'fu'wu'zhong'xin
福龙路	fu'long'lu
花都推广汽车站	hua'du'tui'guang'qi'che'zhan
永光村	yong'guang'cun
石角卫生所	shi'jiao'wei'sheng'suo
向南庄	xiang'nan'zhuang
李溪加油站	li'xi'jia'you'zhan
李溪村委	li'xi'cun'wei
田寮庄	tian'liao'zhuang
新庄	xin'zhuang
汉塘北路	han'tang'bei'lu
汉塘村	han'tang'cun
竹三村	zhu'san'cun
竹料一中	zhu'liao'yi'zhong
竹料墟	zhu'liao'xu
竹料税所	zhu'liao'shui'suo
红旗路口	hong'qi'lu'kou
三凤村	san'feng'cun
九湖村	jiu'hu'cun
联群新村	lian'qun'xin'cun
花东中队	hua'dong'zhong'dui
洛场村	luo'chang'cun
坪东村	ping'dong'cun
花山镇政府	hua'shan'zhen'zheng'fu
广州城市理工学院总站	guang'zhou'cheng'shi'li'gong'xue'yuan'zong'zhan
学府路	xue'fu'lu
邝维煜中学	kuang'wei'yu'zhong'xue
人爱医院	ren'ai'yi'yuan
星光汇摩登百货	xing'guang'hui'mo'deng'bai'huo
长岗	zhang'gang
太岗路西	tai'gang'lu'xi
太岗路中	tai'gang'lu'zhong
岗尾	gang'wei
横沥南环街口	heng'li'nan'huan'jie'kou
横沥中街口	heng'li'zhong'jie'kou
横沥北街口	heng'li'bei'jie'kou
人和二中	ren'he'er'zhong
太成	tai'cheng
江城路	jiang'cheng'lu
金沙小区	jin'sha'xiao'qu
云山路中	yun'shan'lu'zhong
棠澍小学	tang'shu'xiao'xue
广东行政学院	guang'dong'xing'zheng'xue'yuan
毕村桥	bi'cun'qiao
风神花园	feng'shen'hua'yuan
四角围	si'jiao'wei
培正大道口	pei'zheng'da'dao'kou
花都培正学院总站	hua'du'pei'zheng'xue'yuan'zong'zhan
北兴供电所	bei'xing'gong'dian'suo
镇东村	zhen'dong'cun
杨三村	yang'san'cun
杨二村	yang'er'cun
杨一村西	yang'yi'cun'xi
杨一村东	yang'yi'cun'dong
太平中学	tai'ping'zhong'xue
上水	shang'shui
广东机电技术学院	guang'dong'ji'dian'ji'shu'xue'yuan
钟落潭	zhong'luo'tan
钟落潭文化广场总站	zhong'luo'tan'wen'hua'guang'chang'zong'zhan
上水	shang'shui
狮岭振兴村总站	shi'ling'zhen'xing'cun'zong'zhan
团结二队	tuan'jie'er'dui
狮诚医院	shi'cheng'yi'yuan
狮岭五金龙头市场	shi'ling'wu'jin'long'tou'shi'chang
皮革城	pi'ge'cheng
合成	he'cheng
南航路口	nan'hang'lu'kou
狮岭大道中	shi'ling'da'dao'zhong
海布	hai'bu
溢盈广场	yi'ying'guang'chang
明华综合市场	ming'hua'zong'he'shi'chang
杨屋中心市场	yang'wu'zhong'xin'shi'chang
杨屋路口	yang'wu'lu'kou
大华市场	da'hua'shi'chang
圆玄小学	yuan'xuan'xiao'xue
茶园市场	cha'yuan'shi'chang
金菊花园	jin'ju'hua'yuan
钻石花园	zuan'shi'hua'yuan
田美村	tian'mei'cun
云山中学	yun'shan'zhong'xue
龙珠路东	long'zhu'lu'dong
团结路口	tuan'jie'lu'kou
河联村	he'lian'cun
保良村	bao'liang'cun
华侨农场	hua'qiao'nong'chang
花侨市场	hua'qiao'shi'chang
星智少儿成长服务中心	xing'zhi'shao'er'cheng'zhang'fu'wu'zhong'xin
龙苑山庄	long'yuan'shan'zhuang
龙岗大桥南	long'gang'da'qiao'nan
车公庄	che'gong'zhuang
龙岗风柜口	long'gang'feng'gui'kou
龙岗大岭东	long'gang'da'ling'dong
龙岗村路口	long'gang'cun'lu'kou
龙岗村牌坊	long'gang'cun'pai'fang
钟落潭文化广场	zhong'luo'tan'wen'hua'guang'chang
钟落潭市场	zhong'luo'tan'shi'chang
福龙路口	fu'long'lu'kou
神山医院	shen'shan'yi'yuan
两潭路口	liang'tan'lu'kou
两潭路	liang'tan'lu
两上村口	liang'shang'cun'kou
两上村委	liang'shang'cun'wei
两下村委	liang'xia'cun'wei
两下村南	liang'xia'cun'nan
杨山村	yang'shan'cun
杨山村委	yang'shan'cun'wei
九潭村	jiu'tan'cun
峡石村	xia'shi'cun
地铁滘心站总站	di'tie'jiao'xin'zhan'zong'zhan
滘心村	jiao'xin'cun
南周	nan'zhou
龙湖村口	long'hu'cun'kou
龙湖村委	long'hu'cun'wei
龙湖煤气站	long'hu'mei'qi'zhan
联滘路中	lian'jiao'lu'zhong
旧江村桥头	jiu'jiang'cun'qiao'tou
江府路西	jiang'fu'lu'xi
江高镇人民政府	jiang'gao'zhen'ren'min'zheng'fu
江府路东	jiang'fu'lu'dong
郭塘村口	guo'tang'cun'kou
郭塘小学	guo'tang'xiao'xue
郭塘村	guo'tang'cun
郭塘村尾	guo'tang'cun'wei
郭石路口	guo'shi'lu'kou
石南路	shi'nan'lu
石南路口	shi'nan'lu'kou
江高总站	jiang'gao'zong'zhan
金沙北路	jin'sha'bei'lu
小塘北路	xiao'tang'bei'lu
叶边村	ye'bian'cun
叶边市场	ye'bian'shi'chang
大龙头村	da'long'tou'cun
大龙头村西	da'long'tou'cun'xi
蓼江村	liao'jiang'cun
蓼江村小学	liao'jiang'cun'xiao'xue
蓼江上梁	liao'jiang'shang'liang
蓼江村北	liao'jiang'cun'bei
石西路口	shi'xi'lu'kou
鹤岗村	he'gang'cun
峡石村	xia'shi'cun
一一六中学	yi'yi'liu'zhong'xue
良沙一路	liang'sha'yi'lu
良沙一路	liang'sha'yi'lu
龙虎路东	long'hu'lu'dong
小罗村	xiao'luo'cun
东成庄	dong'cheng'zhuang
龙塘中街口	long'tang'zhong'jie'kou
龙塘中街	long'tang'zhong'jie
虎塘村	hu'tang'cun
草庄村	cao'zhuang'cun
茅草庄	mao'cao'zhuang
鹤前东路	he'qian'dong'lu
人和第六小学	ren'he'di'liu'xiao'xue
鹤亭西路口	he'ting'xi'lu'kou
人和墟总站	ren'he'xu'zong'zhan
地铁新和站总站	di'tie'xin'he'zhan'zong'zhan
黎家塘村	li'jia'tang'cun
黎家塘社岭街口	li'jia'tang'she'ling'jie'kou
长沙埗长荔街口	chang'sha'bu'zhang'li'jie'kou
长沙卫生站	chang'sha'wei'sheng'zhan
钟落潭村委会	zhong'luo'tan'cun'wei'hui
广龙路	guang'long'lu
广龙路	guang'long'lu
钟落潭公交总站	zhong'luo'tan'gong'jiao'zong'zhan
平安路	ping'an'lu
钟落潭文化广场	zhong'luo'tan'wen'hua'guang'chang
穗凌公司	sui'ling'gong'si
白土村	bai'tu'cun
钟落潭茅岗村	zhong'luo'tan'mao'gang'cun
茅岗工业区	mao'gang'gong'ye'qu
坑边路	keng'bian'lu
高田村口	gao'tian'cun'kou
沙田村	sha'tian'cun
柠檬长廊	ning'meng'chang'lang
龙岗村口	long'gang'cun'kou
龙岗小学	long'gang'xiao'xue
龙岗村	long'gang'cun
博罗村	bo'luo'cun
竹一村	zhu'yi'cun
纲领南路	gang'ling'nan'lu
纲领村	gang'ling'cun
地铁竹料站	di'tie'zhu'liao'zhan
良田村委总站	liang'tian'cun'wei'zong'zhan
良田大道	liang'tian'da'dao
白沙商贸街	bai'sha'shang'mao'jie
白沙村口	bai'sha'cun'kou
广外南国商学院	guang'wai'nan'guo'shang'xue'yuan
金盆幼儿园	jin'pen'you'er'yuan
金盆永福路口	jin'pen'yong'fu'lu'kou
沙亭苏庄	sha'ting'su'zhuang
杉边马新村	shan'bian'ma'xin'cun
长新路口	zhang'xin'lu'kou
和乐路	he'le'lu
北太路东	bei'tai'lu'dong
北太路柏塘村口	bei'tai'lu'bai'tang'cun'kou
地铁龙归站总站	di'tie'long'gui'zhan'zong'zhan
地铁西村站	di'tie'xi'cun'zhan
松南路	song'nan'lu
钟联路	zhong'lian'lu
钟联路	zhong'lian'lu
红旗中心路中	hong'qi'zhong'xin'lu'zhong
良田中路	liang'tian'zhong'lu
金盆骑马街口	jin'pen'qi'ma'jie'kou
良田良狮路口	liang'tian'liang'shi'lu'kou
光明冯坎头	guang'ming'feng'kan'tou
光明大窿路口	guang'ming'da'long'lu'kou
陈洞枝峰街口	chen'dong'zhi'feng'jie'kou
沙田柠檬长廊总站	sha'tian'ning'meng'chang'lang'zong'zhan
虎塘村委总站	hu'tang'cun'wei'zong'zhan
龙塘幼儿园	long'tang'you'er'yuan
龙塘北路	long'tang'bei'lu
兰桂街	lan'gui'jie
龙和路	long'he'lu
中和路	zhong'he'lu
东凤南路	dong'feng'nan'lu
东凤村委	dong'feng'cun'wei
新胜南街	xin'sheng'nan'jie
竹料综合市场	zhu'liao'zong'he'shi'chang
红旗中心路口	hong'qi'zhong'xin'lu'kou
米岗牌坊	mi'gang'pai'fang
寮采村口	liao'cai'cun'kou
米岗西门	mi'gang'xi'men
米岗村委会	mi'gang'cun'wei'hui
米岗村总站	mi'gang'cun'zong'zhan
广州华南商贸职业学院总站	guang'zhou'hua'nan'shang'mao'zhi'ye'xue'yuan'zong'zhan
西瓜岭后街	xi'gua'ling'hou'jie
广龙路	guang'long'lu
世外桃源	shi'wai'tao'yuan
寮采村委总站	liao'cai'cun'wei'zong'zhan
太和	tai'he
大沥新庄	da'li'xin'zhuang
秀盛路口	xiu'sheng'lu'kou
大沥路	da'li'lu
桂香街	gui'xiang'jie
田心村委	tian'xin'cun'wei
田心中心路	tian'xin'zhong'xin'lu
田心村总站	tian'xin'cun'zong'zhan
民科园大门口	min'ke'yuan'da'men'kou
石湖总站	shi'hu'zong'zhan
军民路	jun'min'lu
大岭顶路东	da'ling'ding'lu'dong
大岭顶路	da'ling'ding'lu
瑚琏农贸市场	hu'lian'nong'mao'shi'chang
永兴村委	yong'xing'cun'wei
龙兴中路口	long'xing'zhong'lu'kou
地铁高增站总站	di'tie'gao'zeng'zhan'zong'zhan
矮岗村	ai'gang'cun
矮岗村委	ai'gang'cun'wei
凤和村	feng'he'cun
西成路	xi'cheng'lu
人和华成路西	ren'he'hua'cheng'lu'xi
人和华成路	ren'he'hua'cheng'lu
人和华成路中	ren'he'hua'cheng'lu'zhong
人和华成路东	ren'he'hua'cheng'lu'dong
人和新街	ren'he'xin'jie
人和聚贤街东	ren'he'ju'xian'jie'dong
人和聚贤街西	ren'he'ju'xian'jie'xi
鸦湖村口	ya'hu'cun'kou
人和华盛南路口	ren'he'hua'sheng'nan'lu'kou
人和华盛南路	ren'he'hua'sheng'nan'lu
人和总站	ren'he'zong'zhan
马洞森林公园总站	ma'dong'sen'lin'gong'yuan'zong'zhan
马洞马新路东	ma'dong'ma'xin'lu'dong
广新路东	guang'xin'lu'dong
马洞广新路中	ma'dong'guang'xin'lu'zhong
广新路	guang'xin'lu
马洞村委	ma'dong'cun'wei
秀水街口	xiu'shui'jie'kou
仲恺农业工程学院北门	zhong'kai'nong'ye'gong'cheng'xue'yuan'bei'men
仲恺农业工程学院	zhong'kai'nong'ye'gong'cheng'xue'yuan
马沥村	ma'li'cun
新湴路口	xin'ban'lu'kou
社边街	she'bian'jie
新湴路	xin'ban'lu
湴湖村委	ban'hu'cun'wei
湴湖黑叶园	ban'hu'hei'ye'yuan
横江庄	heng'jiang'zhuang
湴湖卫生站	ban'hu'wei'sheng'zhan
清湖村总站	qing'hu'cun'zong'zhan
苏元庄东街口	su'yuan'zhuang'dong'jie'kou
清湖牌坊	qing'hu'pai'fang
明泉街	ming'quan'jie
岗贝路口	gang'bei'lu'kou
汇侨南路	hui'qiao'nan'lu
彩滨北路北	cai'bin'bei'lu'bei
沿江路中	yan'jiang'lu'zhong
沿江路总站	yan'jiang'lu'zong'zhan
沙太货运站	sha'tai'huo'yun'zhan
星汇云城	xing'hui'yun'cheng
同宝路	tong'bao'lu
白山村尾	bai'shan'cun'wei
白山村居委	bai'shan'cun'ju'wei
白山村广场	bai'shan'cun'guang'chang
同和	tong'he
罗溪村总站	luo'xi'cun'zong'zhan
南浦村	nan'pu'cun
雄丰村	xiong'feng'cun
井岗村	jing'gang'cun
雄丰路口	xiong'feng'lu'kou
神山	shen'shan
双岗市场	shuang'gang'shi'chang
聚贤街口	ju'xian'jie'kou
鸦湖公园	ya'hu'gong'yuan
流溪半岛总站	liu'xi'ban'dao'zong'zhan
柏兴中路	bai'xing'zhong'lu
柏兴中路东	bai'xing'zhong'lu'dong
柏兴东路	bai'xing'dong'lu
柏塘工业区总站	bai'tang'gong'ye'qu'zong'zhan
横滘大道	heng'jiao'da'dao
横滘小区	heng'jiao'xiao'qu
泽德中学	ze'de'zhong'xue
云城东路	yun'cheng'dong'lu
机场东路口	ji'chang'dong'lu'kou
人和总站	ren'he'zong'zhan
黄榜岭村	huang'bang'ling'cun
镇联街口	zhen'lian'jie'kou
蚌湖公园	bang'hu'gong'yuan
犀牛角村总站	xi'niu'jiao'cun'zong'zhan
天健装饰材料城	tian'jian'zhuang'shi'cai'liao'cheng
榕树头路口	rong'shu'tou'lu'kou
园坛岭路总站	yuan'tan'ling'lu'zong'zhan
园坛岭路	yuan'tan'ling'lu
西岭路口	xi'ling'lu'kou
百花岭北街	bai'hua'ling'bei'jie
望岗小学	wang'gang'xiao'xue
百花岭北街口	bai'hua'ling'bei'jie'kou
黄边北路	huang'bian'bei'lu
白云花园	bai'yun'hua'yuan
解放庄	jie'fang'zhuang
唐阁南总站	tang'ge'nan'zong'zhan
龙塘路	long'tang'lu
龙塘路口	long'tang'lu'kou
金信路总站	jin'xin'lu'zong'zhan
石东路口	shi'dong'lu'kou
石安路	shi'an'lu
石东路	shi'dong'lu
地铁太和站	di'tie'tai'he'zhan
建业路	jian'ye'lu
迴龙亭街口	hui'long'ting'jie'kou
头陂村委	tou'bei'cun'wei
太和派出所	tai'he'pai'chu'suo
和顺路口	he'shun'lu'kou
黄葛坝	huang'ge'ba
飞鹅村	fei'e'cun
横槎	heng'cha
吉洞	ji'dong
帽峰山	mao'feng'shan
帽峰山总站	mao'feng'shan'zong'zhan
侨港路口	qiao'gang'lu'kou
东晓南路口	dong'xiao'nan'lu'kou
北山路口	bei'shan'lu'kou
赤沙路中	chi'sha'lu'zhong
新滘东隧道口	xin'jiao'dong'sui'dao'kou
黄埔古村总站	huang'pu'gu'cun'zong'zhan
土华路西	tu'hua'lu'xi
小洲东路	xiao'zhou'dong'lu
瀛洲生态公园	ying'zhou'sheng'tai'gong'yuan
沥滘大埗头	li'jiao'da'bu'tou
振兴大街	zhen'xing'da'jie
阅江路	yue'jiang'lu
阅江路总站	yue'jiang'lu'zong'zhan
芳园路东	fang'yuan'lu'dong
芳园路	fang'yuan'lu
大干围码头	da'gan'wei'ma'tou
大干围	da'gan'wei
大干围中	da'gan'wei'zhong
大干围北	da'gan'wei'bei
江晓路	jiang'xiao'lu
大江苑	da'jiang'yuan
敦和路	dun'he'lu
敦和路中	dun'he'lu'zhong
敦和街口	dun'he'jie'kou
万寿路总站	wan'shou'lu'zong'zhan
万寿路中	wan'shou'lu'zhong
万寿路东	wan'shou'lu'dong
地铁南浦站	di'tie'nan'pu'zhan
西塱大桥	xi'lang'da'qiao
大桥大街	da'qiao'da'jie
西塱永安	xi'lang'yong'an
西塱大街	xi'lang'da'jie
西塱村委	xi'lang'cun'wei
南漖村	nan'jiao'cun
玉兰路	yu'lan'lu
花围	hua'wei
花围西约	hua'wei'xi'yue
湛涌	zhan'yong
西塱大桥	xi'lang'da'qiao
东方二路总站	dong'fang'er'lu'zong'zhan
临江大道	lin'jiang'da'dao
地铁车陂南站	di'tie'che'bei'nan'zhan
琶洲大桥底	pa'zhou'da'qiao'di
沐陂工业园	mu'bei'gong'ye'yuan
植物园西门	zhi'wu'yuan'xi'men
中科院化学所	zhong'ke'yuan'hua'xue'suo
广州东站汽车站总站	guang'zhou'dong'zhan'qi'che'zhan'zong'zhan
科学城路口	ke'xue'cheng'lu'kou
天河城总站	tian'he'cheng'zong'zhan
聚德中路	ju'de'zhong'lu
悦成路	yue'cheng'lu
南泰路东	nan'tai'lu'dong
明月一路	ming'yue'yi'lu
寺右南街	si'you'nan'jie
东山体育场	dong'shan'ti'yu'chang
合群路	he'qun'lu
龟岗	gui'gang
东湖路北	dong'hu'lu'bei
地铁东湖站	di'tie'dong'hu'zhan
地铁五羊邨站	di'tie'wu'yang'cun'zhan
江北路总站	jiang'bei'lu'zong'zhan
江北路口	jiang'bei'lu'kou
海龙路口	hai'long'lu'kou
安南大街	an'nan'da'jie
芳村码头总站	fang'cun'ma'tou'zong'zhan
山村路	shan'cun'lu
石围塘码头	shi'wei'tang'ma'tou
沙面小学	sha'mian'xiao'xue
长安社区	chang'an'she'qu
地铁梅花园站	di'tie'mei'hua'yuan'zhan
牛利岗南街	niu'li'gang'nan'jie
银利新邨	yin'li'xin'cun
银利街	yin'li'jie
江晓路口	jiang'xiao'lu'kou
瑞宝南路口	rui'bao'nan'lu'kou
东风村	dong'feng'cun
广钢新城总站	guang'gang'xin'cheng'zong'zhan
开拓路	kai'tuo'lu
裕安围东约	yu'an'wei'dong'yue
西塱	xi'lang
柳桥南路	liu'qiao'nan'lu
柳桥北路口	liu'qiao'bei'lu'kou
裕安围	yu'an'wei
兴渔路	xing'yu'lu
白沙	bai'sha
中海金沙湾南门	zhong'hai'jin'sha'wan'nan'men
南滘路口	nan'jiao'lu'kou
沙溪综合市场	sha'xi'zong'he'shi'chang
共和路	gong'he'lu
白沙村委	bai'sha'cun'wei
白沙小学	bai'sha'xiao'xue
星汇金沙二期总站	xing'hui'jin'sha'er'qi'zong'zhan
华堂街	hua'tang'jie
礼传三街	li'chuan'san'jie
环洲四路	huan'zhou'si'lu
大沙路口	da'sha'lu'kou
万科四季花城	wan'ke'si'ji'hua'cheng
大沙村委	da'sha'cun'wei
黄岐高级中学	huang'qi'gao'ji'zhong'xue
后海村口	hou'hai'cun'kou
后海村总站	hou'hai'cun'zong'zhan
星汇云城总站	xing'hui'yun'cheng'zong'zhan
南湖半岛花园总站	nan'hu'ban'dao'hua'yuan'zong'zhan
空港大道	kong'gang'da'dao
司法学校	si'fa'xue'xiao
江景路	jiang'jing'lu
黄园路	huang'yuan'lu
黄鹤路	huang'he'lu
司法学校	si'fa'xue'xiao
广东省机械技师学院总站	guang'dong'sheng'ji'xie'ji'shi'xue'yuan'zong'zhan
卫生职业学院北门	wei'sheng'zhi'ye'xue'yuan'bei'men
石马涌边大街中	shi'ma'yong'bian'da'jie'zhong
石马涌边大街南	shi'ma'yong'bian'da'jie'nan
环村北路北	huan'cun'bei'lu'bei
环村北路中	huan'cun'bei'lu'zhong
环村北路南	huan'cun'bei'lu'nan
新石一环路口	xin'shi'yi'huan'lu'kou
七星岗工业路	qi'xing'gang'gong'ye'lu
七星岗工业路南	qi'xing'gang'gong'ye'lu'nan
大沥村	da'li'cun
大沥欧庄	da'li'ou'zhuang
民科园北门	min'ke'yuan'bei'men
天骄物流园	tian'jiao'wu'liu'yuan
申通物流	shen'tong'wu'liu
永宁庄	yong'ning'zhuang
为民小学	wei'min'xiao'xue
市饲料研究所	shi'si'liao'yan'jiu'suo
草庄公园	cao'zhuang'gong'yuan
龙塘村	long'tang'cun
罗窑路	luo'yao'lu
小罗村口	xiao'luo'cun'kou
大罗村总站	da'luo'cun'zong'zhan
元下田三路口	yuan'xia'tian'san'lu'kou
元下田南路口	yuan'xia'tian'nan'lu'kou
广外北门	guang'wai'bei'men
坤和街口	kun'he'jie'kou
永兴村	yong'xing'cun
仑头村	lun'tou'cun
嘉禾总站	jia'he'zong'zhan
汇侨路	hui'qiao'lu
南航新村	nan'hang'xin'cun
景安街	jing'an'jie
长红西路	chang'hong'xi'lu
福龙路	fu'long'lu
白云高尔夫花园总站	bai'yun'gao'er'fu'hua'yuan'zong'zhan
恤孤院路	xu'gu'yuan'lu
兴国路	xing'guo'lu
培正路	pei'zheng'lu
新河浦路	xin'he'pu'lu
棠下小区总站	tang'xia'xiao'qu'zong'zhan
唐宁花园	tang'ning'hua'yuan
棠溪车场总站	tang'xi'che'chang'zong'zhan
环镇路口	huan'zhen'lu'kou
江高	jiang'gao
何布村	he'bu'cun
何布工业区	he'bu'gong'ye'qu
朱家庄	zhu'jia'zhuang
茅山	mao'shan
茅山村委会	mao'shan'cun'wei'hui
茅山新庄口	mao'shan'xin'zhuang'kou
刘家路口	liu'jia'lu'kou
田心路口	tian'xin'lu'kou
田心花园	tian'xin'hua'yuan
上社路口	shang'she'lu'kou
大石岗	da'shi'gang
石龙档铺街	shi'long'dang'pu'jie
石龙	shi'long
朗头村	lang'tou'cun
朗头中街口	lang'tou'zhong'jie'kou
五丰工业区	wu'feng'gong'ye'qu
五丰村	wu'feng'cun
中八小学	zhong'ba'xiao'xue
郭塘西岭工业区	guo'tang'xi'ling'gong'ye'qu
机保段新村	ji'bao'duan'xin'cun
广州佐航花都雅瑶恒通汽车站总站	guang'zhou'zuo'hang'hua'du'ya'yao'heng'tong'qi'che'zhan'zong'zhan
雄丰街口	xiong'feng'jie'kou
凤凰三路	feng'huang'san'lu
马兰形	ma'lan'xing
蟹庄村	xie'zhuang'cun
马洞广新路	ma'dong'guang'xin'lu
茅岗新岗路	mao'gang'xin'gang'lu
陈洞村	chen'dong'cun
打鼓岭	da'gu'ling
金盆钱岗庄	jin'pen'qian'gang'zhuang
金盆中路	jin'pen'zhong'lu
沙田村委会	sha'tian'cun'wei'hui
莲塘村	lian'tang'cun
燕塘村	yan'tang'cun
佛田路口	fu'tian'lu'kou
金燕庄	jin'yan'zhuang
鹤亭工业区北六路口	he'ting'gong'ye'qu'bei'liu'lu'kou
三盛	san'sheng
鹤亭工业区北二路口	he'ting'gong'ye'qu'bei'er'lu'kou
凤尾	feng'wei
横坑	heng'keng
秀水	xiu'shui
白鳝塘	bai'shan'tang
南浦村	nan'pu'cun
罗溪路	luo'xi'lu
罗溪村委	luo'xi'cun'wei
罗溪中路	luo'xi'zhong'lu
井岗大道北街	jing'gang'da'dao'bei'jie
井岗村委	jing'gang'cun'wei
井岗大道北街口	jing'gang'da'dao'bei'jie'kou
井岗大道南街口	jing'gang'da'dao'nan'jie'kou
聚龙村	ju'long'cun
茅山新二社	mao'shan'xin'er'she
江村车站生活区	jiang'cun'che'zhan'sheng'huo'qu
江村车站派出所	jiang'cun'che'zhan'pai'chu'suo
大菀路口	da'wan'lu'kou
夏茅客运站	xia'mao'ke'yun'zhan
夏茅大道	xia'mao'da'dao
夏茅市场	xia'mao'shi'chang
海口村	hai'kou'cun
环滘	huan'jiao
鹤边员村	he'bian'yuan'cun
鹤边军民西路	he'bian'jun'min'xi'lu
夏茅大道口	xia'mao'da'dao'kou
朝阳海头街	zhao'yang'hai'tou'jie
华阳路口	hua'yang'lu'kou
杨梅岗村	yang'mei'gang'cun
杨梅岗村口	yang'mei'gang'cun'kou
石井总站	shi'jing'zong'zhan
大坦沙充电站总站	da'tan'sha'chong'dian'zhan'zong'zhan
南方医院	nan'fang'yi'yuan
滘心村	jiao'xin'cun
骏威客车厂	jun'wei'ke'che'chang
滘心大围工业区总站	jiao'xin'da'wei'gong'ye'qu'zong'zhan
南方村	nan'fang'cun
竹料公交场	zhu'liao'gong'jiao'chang
横布庄路口	heng'bu'zhuang'lu'kou
万里	wan'li
罗汉塘	luo'han'tang
安置区北区路口	an'zhi'qu'bei'qu'lu'kou
人和安置区	ren'he'an'zhi'qu
新方华路北	xin'fang'hua'lu'bei
民强村北	min'qiang'cun'bei
明星路口	ming'xing'lu'kou
新方华路南	xin'fang'hua'lu'nan
方华公路	fang'hua'gong'lu
人和总站	ren'he'zong'zhan
下坑庄	xia'keng'zhuang
城壕庄	cheng'hao'zhuang
鸦湖方石村	ya'hu'fang'shi'cun
广州空港实验中学	guang'zhou'kong'gang'shi'yan'zhong'xue
西成村委	xi'cheng'cun'wei
西成路中	xi'cheng'lu'zhong
沙太路北总站	sha'tai'lu'bei'zong'zhan
海联中路	hai'lian'zhong'lu
怡乐路	yi'le'lu
江海路	jiang'hai'lu
建基路	jian'ji'lu
天健创意园总站	tian'jian'chuang'yi'yuan'zong'zhan
天盈路	tian'ying'lu
地铁三溪站总站	di'tie'san'xi'zhan'zong'zhan
公仔岑街	gong'zai'cen'jie
胡氏祠堂	hu'shi'ci'tang
嘉禾金铂天地	jia'he'jin'bo'tian'di
望岗工业一路	wang'gang'gong'ye'yi'lu
大岭北街	da'ling'bei'jie
望岗西岭总站	wang'gang'xi'ling'zong'zhan
翠竹园总站	cui'zhu'yuan'zong'zhan
云祥居委	yun'xiang'ju'wei
小城花园	xiao'cheng'hua'yuan
云祥路	yun'xiang'lu
倚绿山庄	yi'lyu'shan'zhuang
永兴庄总站	yong'xing'zhuang'zong'zhan
永兴南街口	yong'xing'nan'jie'kou
横岗南街	heng'gang'nan'jie
大埔南二街	da'bu'nan'er'jie
棠涌南街	tang'yong'nan'jie
祥岗社区	xiang'gang'she'qu
祥岗后街	xiang'gang'hou'jie
东平横岗东街口	dong'ping'heng'gang'dong'jie'kou
东平大道东	dong'ping'da'dao'dong
东平大道	dong'ping'da'dao
武警指挥学院	wu'jing'zhi'hui'xue'yuan
嘉禾八一科技园	jia'he'ba'yi'ke'ji'yuan
新科上村	xin'ke'shang'cun
新村	xin'cun
下新村	xia'xin'cun
石井大道	shi'jing'da'dao
石井大道中	shi'jing'da'dao'zhong
石井大道	shi'jing'da'dao
石井大道	shi'jing'da'dao
龙湖路口	long'hu'lu'kou
石井大道北	shi'jing'da'dao'bei
龙湖工业区总站	long'hu'gong'ye'qu'zong'zhan
小塱村	xiao'lang'cun
瑞祥路东	rui'xiang'lu'dong
瑞祥路西	rui'xiang'lu'xi
永和禾丰新村总站	yong'he'he'feng'xin'cun'zong'zhan
禾岭路南	he'ling'lu'nan
禾岭路中	he'ling'lu'zhong
香雪山南	xiang'xue'shan'nan
南云四路北	nan'yun'si'lu'bei
光谱东路	guang'pu'dong'lu
摇田河路中	yao'tian'he'lu'zhong
新业路北	xin'ye'lu'bei
永和	yong'he
禾丰二纵路口	he'feng'er'zong'lu'kou
永盛路口	yong'sheng'lu'kou
永盛路	yong'sheng'lu
永华路	yong'hua'lu
地铁沥滘站	di'tie'li'jiao'zhan
新鱼桥头	xin'yu'qiao'tou
瑞海路口	rui'hai'lu'kou
龙溪大道总站	long'xi'da'dao'zong'zhan
洪石坊	hong'shi'fang
芳村车管所	fang'cun'che'guan'suo
增南路	zeng'nan'lu
沥滘大埗头	li'jiao'da'bu'tou
沥滘路	li'jiao'lu
新业路中	xin'ye'lu'zhong
蚝壳洲东街	hao'ke'zhou'dong'jie
南社街	nan'she'jie
涌边街	yong'bian'jie
石岗路	shi'gang'lu
花海街口	hua'hai'jie'kou
杜家巷	du'jia'xiang
花海街	hua'hai'jie
百花路口	bai'hua'lu'kou
百花小区	bai'hua'xiao'qu
芳村丰年路	fang'cun'feng'nian'lu
水秀二路总站	shui'xiu'er'lu'zong'zhan
水秀二路	shui'xiu'er'lu
沙渡路	sha'du'lu
纺织路	fang'zhi'lu
中南花园总站	zhong'nan'hua'yuan'zong'zhan
黄岐中学	huang'qi'zhong'xue
嘉洲广场	jia'zhou'guang'chang
郭村小区	guo'cun'xiao'qu
五眼桥西约	wu'yan'qiao'xi'yue
五眼桥总站	wu'yan'qiao'zong'zhan
五眼桥小学	wu'yan'qiao'xiao'xue
大朗夏边总站	da'lang'xia'bian'zong'zhan
白云湖公园北门	bai'yun'hu'gong'yuan'bei'men
大朗工业路口	da'lang'gong'ye'lu'kou
大朗工业路	da'lang'gong'ye'lu
高增一村	gao'zeng'yi'cun
民强村	min'qiang'cun
高增村	gao'zeng'cun
市七十三中学	shi'qi'shi'san'zhong'xue
人和村	ren'he'cun
高增大桥北	gao'zeng'da'qiao'bei
人和北后东街口	ren'he'bei'hou'dong'jie'kou
人和大街	ren'he'da'jie
和龙村	he'long'cun
兴太一路东	xing'tai'yi'lu'dong
帽峰山西	mao'feng'shan'xi
均田	jun'tian
胡屋	hu'wu
牛牯潭	niu'gu'tan
白山村	bai'shan'cun
大山李	da'shan'li
何排村	he'pai'cun
兴太三路口	xing'tai'san'lu'kou
穗丰村委	sui'feng'cun'wei
大水村	da'shui'cun
岗板村	gang'ban'cun
苦板塘	ku'ban'tang
兴丰村总站	xing'feng'cun'zong'zhan
环洲二路东	huan'zhou'er'lu'dong
时代糖果	shi'dai'tang'guo
草场工业大道南	cao'chang'gong'ye'da'dao'nan
草场工业大道中	cao'chang'gong'ye'da'dao'zhong
草场工业大道北	cao'chang'gong'ye'da'dao'bei
山口园路	shan'kou'yuan'lu
东秀路总站	dong'xiu'lu'zong'zhan
东秀路中	dong'xiu'lu'zhong
东秀路口	dong'xiu'lu'kou
五一大道北	wu'yi'da'dao'bei
五一大道中	wu'yi'da'dao'zhong
五一大道口	wu'yi'da'dao'kou
城西花园	cheng'xi'hua'yuan
云城南二路	yun'cheng'nan'er'lu
竹料总站	zhu'liao'zong'zhan
平沙总站	ping'sha'zong'zhan
松园中西街南	song'yuan'zhong'xi'jie'nan
松园中西街	song'yuan'zhong'xi'jie
平沙公园	ping'sha'gong'yuan
松园街中	song'yuan'jie'zhong
松园街北	song'yuan'jie'bei
加石路口	jia'shi'lu'kou
加石路	jia'shi'lu
加石路中	jia'shi'lu'zhong
加石路	jia'shi'lu
马洞马新路	ma'dong'ma'xin'lu
汇侨新城总站	hui'qiao'xin'cheng'zong'zhan
萧岗齐富二横路	xiao'gang'qi'fu'er'heng'lu
悦云路口	yue'yun'lu'kou
夏茅总站	xia'mao'zong'zhan
向西大道中	xiang'xi'da'dao'zhong
向西大道口	xiang'xi'da'dao'kou
石岗西基街	shi'gang'xi'ji'jie
石岗东街	shi'gang'dong'jie
马务联和西街	ma'wu'lian'he'xi'jie
马务大街	ma'wu'da'jie
十字路口	shi'zi'lu'kou
十字路	shi'zi'lu
夏茅工业区	xia'mao'gong'ye'qu
鹤亭第一工业区	he'ting'di'yi'gong'ye'qu
东华村口	dong'hua'cun'kou
人和总站	ren'he'zong'zhan
南岭中路	nan'ling'zhong'lu
南岭中路口	nan'ling'zhong'lu'kou
南岭工业区中路	nan'ling'gong'ye'qu'zhong'lu
南岭工业区四横路	nan'ling'gong'ye'qu'si'heng'lu
南岭工业区南路	nan'ling'gong'ye'qu'nan'lu
南岭工业区南路东	nan'ling'gong'ye'qu'nan'lu'dong
南岭工业区八横路	nan'ling'gong'ye'qu'ba'heng'lu
长湴工业一路	zhang'ban'gong'ye'yi'lu
天安科技园总站	tian'an'ke'ji'yuan'zong'zhan
琶洲保利总站	pa'zhou'bao'li'zong'zhan
赤沙村口	chi'sha'cun'kou
海珠涌大桥南	hai'zhu'yong'da'qiao'nan
海珠涌大桥北	hai'zhu'yong'da'qiao'bei
花湾路	hua'wan'lu
西后街	xi'hou'jie
仁厚直街	ren'hou'zhi'jie
杏花大街	xing'hua'da'jie
招村大街	zhao'cun'da'jie
沥滘大街	li'jiao'da'jie
振海路	zhen'hai'lu
南洲北路	nan'zhou'bei'lu
礼岗路口	li'gang'lu'kou
礼岗路	li'gang'lu
南泰路口	nan'tai'lu'kou
坦尾西路	tan'wei'xi'lu
坦尾牌坊	tan'wei'pai'fang
东海北路	dong'hai'bei'lu
东海北路北	dong'hai'bei'lu'bei
西海北路	xi'hai'bei'lu
河沙中路西	he'sha'zhong'lu'xi
荷景路	he'jing'lu
广州圆	guang'zhou'yuan
东沙桥底	dong'sha'qiao'di
翠宝路	cui'bao'lu
地铁沥滘站	di'tie'li'jiao'zhan
沥滘路西	li'jiao'lu'xi
永翠路总站	yong'cui'lu'zong'zhan
新业路	xin'ye'lu
万胜围	wan'sheng'wei
西塱	xi'lang
坑口	keng'kou
花地湾	hua'di'wan
芳村	fang'cun
黄沙	huang'sha
长寿路	chang'shou'lu
陈家祠	chen'jia'ci
西门口	xi'men'kou
公园前	gong'yuan'qian
农讲所	nong'jiang'suo
烈士陵园	lie'shi'ling'yuan
东山口	dong'shan'kou
杨箕	yang'ji
体育西路	ti'yu'xi'lu
体育中心	ti'yu'zhong'xin
黄边	huang'bian
江夏	jiang'xia
萧岗	xiao'gang
白云文化广场	bai'yun'wen'hua'guang'chang
白云公园	bai'yun'gong'yuan
飞翔公园	fei'xiang'gong'yuan
三元里	san'yuan'li
广州火车站	guang'zhou'huo'che'zhan
越秀公园	yue'xiu'gong'yuan
纪念堂	ji'nian'tang
海珠广场	hai'zhu'guang'chang
市二宫	shi'er'gong
江南西	jiang'nan'xi
昌岗	chang'gang
江泰路	jiang'tai'lu
东晓南	dong'xiao'nan
南洲	nan'zhou
洛溪	luo'xi
南浦	nan'pu
会江	hui'jiang
石壁	shi'bi
广州南站	guang'zhou'nan'zhan
番禺广场	pan'yu'guang'chang
市桥	shi'qiao
汉溪长隆	han'xi'zhang'long
大石	da'shi
厦滘	sha'jiao
沥滘	li'jiao
大塘	da'tang
客村	ke'cun
广州塔	guang'zhou'ta
珠江新城	zhu'jiang'xin'cheng
石牌桥	shi'pai'qiao
岗顶	gang'ding
华师	hua'shi
五山	wu'shan
天河客运站	tian'he'ke'yun'zhan
林和西	lin'he'xi
广州东站	guang'zhou'dong'zhan
燕塘	yan'tang
梅花园	mei'hua'yuan
京溪南方医院	jing'xi'nan'fang'yi'yuan
同和	tong'he
永泰	yong'tai
白云大道北	bai'yun'da'dao'bei
嘉禾望岗	jia'he'wang'gang
龙归	long'gui
人和	ren'he
机场南	ji'chang'nan
黄村	huang'cun
车陂	che'bei
车陂南	che'bei'nan
万胜围	wan'sheng'wei
官洲	guan'zhou
大学城北	da'xue'cheng'bei
大学城南	da'xue'cheng'nan
新造	xin'zao
官桥	guan'qiao
石碁	shi'qi
海傍	hai'bang
低涌	di'yong
东涌	dong'yong
庆盛	qing'sheng
黄阁汽车城	huang'ge'qi'che'cheng
黄阁	huang'ge
蕉门	jiao'men
金洲	jin'zhou
高增	gao'zeng
文冲	wen'chong
大沙东	da'sha'dong
大沙地	da'sha'di
鱼珠	yu'zhu
三溪	san'xi
东圃	dong'pu
科韵路	ke'yun'lu
员村	yuan'cun
潭村	tan'cun
猎德	lie'de
五羊邨	wu'yang'cun
动物园	dong'wu'yuan
区庄	qu'zhuang
淘金	tao'jin
小北	xiao'bei
西村	xi'cun
西场	xi'chang
中山八	zhong'shan'ba
坦尾	tan'wei
滘口	jiao'kou
凤凰新村	feng'huang'xin'cun
沙园	sha'yuan
宝岗大道	bao'gang'da'dao
晓港	xiao'gang
中大	zhong'da
鹭江	lu'jiang
赤岗	chi'gang
磨碟沙	mo'die'sha
新港东	xin'gang'dong
琶洲	pa'zhou
菊树	ju'shu
龙溪	long'xi
金融高新区	jin'rong'gao'xin'qu
千灯湖	qian'deng'hu
虫雷 岗	chong'lei'gang
南桂路	nan'gui'lu
桂城	gui'cheng
朝安	chao'an
普君北路	pu'jun'bei'lu
祖庙	zu'miao
同济路	tong'ji'lu
季华园	ji'hua'yuan
魁奇路	kui'qi'lu
体育中心南	ti'yu'zhong'xin'nan
天河南	tian'he'nan
黄埔大道	huang'pu'da'dao
妇儿中心	fu'er'zhong'xin
花城大道	hua'cheng'da'dao
大剧院	da'ju'yuan
海心沙	hai'xin'sha
浔峰岗	xun'feng'gang
横沙	heng'sha
沙贝	sha'bei
河沙	he'sha
如意坊	ru'yi'fang
文化公园	wen'hua'gong'yuan
一德路	yi'de'lu
北京路	bei'jing'lu
团一大广场	tuan'yi'da'guang'chang
东湖	dong'hu
黄花岗	huang'hua'gang
沙河顶	sha'he'ding
沙河	sha'he
天平架	tian'ping'jia
长湴	zhang'ban
燕岗	yan'gang
沙涌	sha'yong
鹤洞	he'dong
植物园	zhi'wu'yuan
龙洞	long'dong
柯木塱	ke'mu'lang
高塘石	gao'tang'shi
黄陂	huang'po
金峰	jin'feng
暹岗	xian'gang
苏元	su'yuan
萝岗	luo'gang
香雪	xiang'xue
谢村	xie'cun
钟村	zhong'cun
南村万博	nan'cun'wan'bo
员岗	yuan'gang
板桥	ban'qiao
澜石	lan'shi
世纪莲	shi'ji'lian
东平	dong'ping
新城东	xin'cheng'dong
飞鹅岭	fei'e'ling
花都汽车城	hua'du'qi'che'cheng
广州北站	guang'zhou'bei'zhan
花城路	hua'cheng'lu
花果山公园	hua'guo'shan'gong'yuan
花都广场	hua'du'guang'chang
马鞍山公园	ma'an'shan'gong'yuan
莲塘	lian'tang
清㘵	qing'bu
清塘	qing'tang
机场北	ji'chang'bei
飞沙角	fei'sha'jiao
广隆	guang'long
大涌	da'yong
塘坑	tang'keng
南横	nan'heng
南沙客运港	nan'sha'ke'yun'gang
裕丰围	yu'feng'wei
双岗	shuang'gang
南海神庙	nan'hai'shen'miao
夏园	xia'yuan
南岗	nan'gang
沙村	sha'cun
白江	bai'jiang
新塘	xin'tang
官湖	guan'hu
新沙	xin'sha
新和	xin'he
红卫	hong'wei
新南	xin'nan
枫下	feng'xia
知识城	zhi'shi'cheng
何棠下	he'tang'xia
旺村	wang'cun
汤村	tang'cun
镇龙北	zhen'long'bei
镇龙	zhen'long
广州塔东	guang'zhou'ta'dong
猎德大桥南	lie'de'da'qiao'nan
琶醍	pa'ti
南风	nan'feng
会展西	hui'zhan'xi
会展中	hui'zhan'zhong
会展东	hui'zhan'dong
琶洲大桥南	pa'zhou'da'qiao'nan
琶洲塔	pa'zhou'ta
广州塔	guang'zhou'ta
万胜围	wan'sheng'wei
石溪	shi'xi
白云东平	bai'yun'dong'ping
夏良	xia'liang
太和	tai'he
竹料	zhu'liao
钟落潭	zhong'luo'tan
马沥	ma'li
增城广场	zeng'cheng'guang'chang
太平	tai'ping
神岗	shen'gang
赤草	chi'cao
从化客运站	cong'hua'ke'yun'zhan
东风	dong'feng
钟岗	zhong'gang
朱村	zhu'cun
山田	shan'tian
凤岗	feng'gang
坑贝	keng'bei
中新	zhong'xin
镇龙西	zhen'long'xi
天河公园	tian'he'gong'yuan
棠东	tang'dong
大观南路	da'guan'nan'lu
天河智慧城	tian'he'zhi'hui'cheng
神舟路	shen'zhou'lu
科学城	ke'xue'cheng
水西	shui'xi
长平	chang'ping
金坑	jin'keng
同福西	tong'fu'xi
华林寺	hua'lin'si
同德	tong'de
上步	shang'bu
石潭	shi'tan
小坪	xiao'ping
石井	shi'jing
亭岗	ting'gang
滘心	jiao'xin
鹅掌坦	e'zhang'tan
聚龙	ju'long
冼村	xian'cun
龙潭	long'tan
沙溪	sha'xi
横沥	heng'li
万顷沙	wan'qing'sha
市广路	shi'guang'lu
陈头岗	chen'tou'gang
地铁香雪	di'tie'xiang'xue
区少年宫	qu'shao'nian'gong
线坑	xian'keng
市民广场	shi'min'guang'chang
会议中心	hui'yi'zhong'xin
地铁水西	di'tie'shui'xi
峻泰路	jun'tai'lu
北师大实验学校	bei'shi'da'shi'yan'xue'xiao
地铁长平	di'tie'chang'ping
羌洞	qiang'dong
长岭居小学	chang'ling'ju'xiao'xue
岭头	ling'tou
干部健康中心	gan'bu'jian'kang'zhong'xin
岭头东	ling'tou'dong
贤江西	xian'jiang'xi
贤江公园	xian'jiang'gong'yuan
贤江	xian'jiang
新丰路	xin'feng'lu
水西	shui'xi
南庄	nan'zhuang
湖涌	hu'yong
绿岛湖	lyu'dao'hu
智慧新城	zhi'hui'xin'cheng
张槎	zhang'cha
石湾	shi'wan
沙岗	sha'gang
石梁	shi'liang
湾华	wan'hua
登洲	deng'zhou
花卉世界	hua'hui'shi'jie
仙涌	xian'yong
石洲	shi'zhou
林岳西	lin'yue'xi
林岳东	lin'yue'dong
华翠路	hua'cui'lu
夏西	xia'xi
夏东	xia'dong
康怡公园	kang'yi'gong'yuan
平西	ping'xi
平南	ping'nan
玉器街	yu'qi'jie
中区	zhong'qu
三山新城北	san'shan'xin'cheng'bei
大洲	da'zhou
陈村北	chen'cun'bei
陈村	chen'cun
锦龙	jin'long
南涌	nan'yong
美的	mei'di
北滘公园	bei'jiao'gong'yuan
广州南站	guang'zhou'nan'zhan
美的大道	mei'di'da'dao